cid,cname,O.S.N.,Candidate,Party,EVM Votes,Postal Votes,Total Votes,PctVotes
1,RATABARI,1,BIJOY MALAKAR,Bharatiya Janata Party,46890,0,46890,55.74
1,RATABARI,2,SAMBHU SING MALLAH,Indian National Congress,35179,0,35179,41.82
1,RATABARI,3,SANCHITA SUKLA,SOCIALIST UNITY CENTRE OF INDIA (COMMUNIST),427,0,427,0.51
1,RATABARI,4,DIPENDRA DAS,Independent,109,0,109,0.13
1,RATABARI,5,BIKASH LAL DHUBI,Independent,151,0,151,0.18
1,RATABARI,6,BISHNU DHARI MALAH,Independent,137,0,137,0.16
1,RATABARI,7,BEBUL DAS,Independent,205,0,205,0.24
1,RATABARI,8,SUJIT ROY,Independent,351,0,351,0.42
1,RATABARI,9,NOTA,None of the Above,670,0,670,0.8
2,PATHARKANDI,1,KRISHNENDU PAUL,Bharatiya Janata Party,38806,0,38806,45.67
2,PATHARKANDI,2,SACHIN SAHOO,Indian National Congress,43344,0,43344,51.02
2,PATHARKANDI,3,SABBIR AHMED,Asom Gana Parishad,298,0,298,0.35
2,PATHARKANDI,4,JAYANTA SINHA,Republican Party of India,98,0,98,0.12
2,PATHARKANDI,5,NURUL ISLAM,All India Forward Bloc,44,0,44,0.05
2,PATHARKANDI,6,BULU CHANDA,SOCIALIST UNITY CENTRE OF INDIA (COMMUNIST),41,0,41,0.05
2,PATHARKANDI,7,MD. BAHAR UDDIN,Rashtriya Ulama Council,52,0,52,0.06
2,PATHARKANDI,8,HUMAYUN KABIR,Assam Jatiya Parishad,140,0,140,0.16
2,PATHARKANDI,9,IBRAHIM ALI,Independent,108,0,108,0.13
2,PATHARKANDI,10,YEAFUS ALI,Independent,65,0,65,0.08
2,PATHARKANDI,11,CHANDAN DAS,Independent,59,0,59,0.07
2,PATHARKANDI,12,YASHOBANTA KUAMR DAS,Independent,80,0,80,0.09
2,PATHARKANDI,13,SANJOY KUMAR MALAKAR,Independent,99,0,99,0.12
2,PATHARKANDI,14,SAHIN UZ JAMAN,Independent,389,0,389,0.46
2,PATHARKANDI,15,SHIHAB UDDIN AHMED,Independent,621,0,621,0.73
2,PATHARKANDI,16,NOTA,None of the Above,718,0,718,0.85
3,KARIMGANJ NORTH,1,KAMALAKHYA DEY PURKAYASTHA,Indian National Congress,37194,623,37817,40.45
3,KARIMGANJ NORTH,2,DR MANASH DAS,Bharatiya Janata Party,29346,809,30155,32.26
3,KARIMGANJ NORTH,3,AHAD UDDIN,Rashtriya Ulama Council,172,2,174,0.19
3,KARIMGANJ NORTH,4,GOPAL CHANDRA PAUL,Samajwadi Party,52,0,52,0.06
3,KARIMGANJ NORTH,5,NAZRUL ISLAM CHOUDHURY,All India Forward Bloc,435,6,441,0.47
3,KARIMGANJ NORTH,6,SUJIT KUMAR PAUL,SOCIALIST UNITY CENTRE OF INDIA (COMMUNIST),96,4,100,0.11
3,KARIMGANJ NORTH,7,ABDUL JABBAR CHOUDHURY,Independent,81,1,82,0.09
3,KARIMGANJ NORTH,8,JAKIR HUSSAIN,Independent,381,1,382,0.41
3,KARIMGANJ NORTH,9,MD JUBAIR AHMED CHOUDHURY,Independent,79,4,83,0.09
3,KARIMGANJ NORTH,10,DEBAJYOTI DEB ROY (SUJAN),Independent,363,16,379,0.41
3,KARIMGANJ NORTH,11,NAZIM UDDIN KHAN,Independent,276,1,277,0.3
3,KARIMGANJ NORTH,12,MOHAMMAD ABDUL BATIN,Independent,58,0,58,0.06
3,KARIMGANJ NORTH,13,RUHUL QUDDUS,Independent,78,1,79,0.08
3,KARIMGANJ NORTH,14,LUTFUR RAHMAN,Independent,330,1,331,0.35
3,KARIMGANJ NORTH,15,SAHABUL ISLAM CHOUDHURY,Independent,22142,128,22270,23.82
3,KARIMGANJ NORTH,16,NOTA,None of the Above,801,8,809,0.87
4,KARIMGANJ SOUTH,1,AZIZ AHMED KHAN,Asom Gana Parishad,15358,0,15358,41.48
4,KARIMGANJ SOUTH,2,SIDDEQUE AHMED,Indian National Congress,20225,0,20225,54.62
4,KARIMGANJ SOUTH,3,PRONAB KUMAR ROY,Rashtriya Lok Samta Party,220,0,220,0.59
4,KARIMGANJ SOUTH,4,ABU SUFIAN,Independent,32,0,32,0.09
4,KARIMGANJ SOUTH,5,ABDUL BASIT,Independent,26,0,26,0.07
4,KARIMGANJ SOUTH,6,SUFIAN AHMED,Independent,179,0,179,0.48
4,KARIMGANJ SOUTH,7,JAHARUL HAQUE,Independent,32,0,32,0.09
4,KARIMGANJ SOUTH,8,FORZAN KHAN,Independent,29,0,29,0.08
4,KARIMGANJ SOUTH,9,FAIZ AHMED,Independent,42,0,42,0.11
4,KARIMGANJ SOUTH,10,BIMAL KRISHNA DAS,Independent,112,0,112,0.3
4,KARIMGANJ SOUTH,11,BILAL AHMED,Independent,37,0,37,0.1
4,KARIMGANJ SOUTH,12,RAJESH DEY PURKAYASTHA,Independent,54,0,54,0.15
4,KARIMGANJ SOUTH,13,SHAMIM AHMED CHOUDHURY,Independent,55,0,55,0.15
4,KARIMGANJ SOUTH,14,SAYED ALI AHMED,Independent,96,0,96,0.26
4,KARIMGANJ SOUTH,15,HUSSAIN AHMED,Independent,254,0,254,0.69
4,KARIMGANJ SOUTH,16,NOTA,None of the Above,278,0,278,0.75
5,BADARPUR,1,ABDUL AZIZ,All India United Democratic Front,47683,544,48227,55.13
5,BADARPUR,2,BISWARUP BHATTACHARJEE,Bharatiya Janata Party,34615,535,35150,40.18
5,BADARPUR,3,NIZAM UDDIN,Rashtriya Ulama Council,188,3,191,0.22
5,BADARPUR,4,SAHAB UDDIN,Assam Jatiya Parishad,1505,12,1517,1.73
5,BADARPUR,5,OLIOUR RAHAMAN TAPADAR,Independent,44,0,44,0.05
5,BADARPUR,6,ABDUL MALIK,Independent,174,1,175,0.2
5,BADARPUR,7,ABDUL HASIB,Independent,99,2,101,0.12
5,BADARPUR,8,ABDUS SUKKUR BEIG,Independent,44,1,45,0.05
5,BADARPUR,9,ENAM UDDIN,Independent,54,5,59,0.07
5,BADARPUR,10,KABIL MIYA,Independent,158,2,160,0.18
5,BADARPUR,11,NAJIM UDDIN,Independent,126,2,128,0.15
5,BADARPUR,12,BAHAR ASHIK,Independent,110,0,110,0.13
5,BADARPUR,13,RASID AHMED,Independent,123,0,123,0.14
5,BADARPUR,14,RIYAJ UDDIN,Independent,293,0,293,0.33
5,BADARPUR,15,NOTA,None of the Above,1135,14,1149,1.31
6,HAILAKANDI,1,ZAKIR HUSSAIN LASKAR,All India United Democratic Front,70541,516,71057,55.15
6,HAILAKANDI,2,MILON DAS,Bharatiya Janata Party,46720,583,47303,36.72
6,HAILAKANDI,3,SAFIQUE KAMAL BARLASKAR,All India Trinamool Congress,384,5,389,0.3
6,HAILAKANDI,4,MONUJ MOHAN DEB,Bharatiya Gana Parishad,217,9,226,0.18
6,HAILAKANDI,5,SUSHIL PAUL,SOCIALIST UNITY CENTRE OF INDIA (COMMUNIST),126,5,131,0.1
6,HAILAKANDI,6,ABUL HUSSAIN BARBHUIYA,Independent,84,0,84,0.07
6,HAILAKANDI,7,WAHIDUL ISLAM CHOUDHURY,Independent,84,0,84,0.07
6,HAILAKANDI,8,KSHITISH RANJAN PAUL,Independent,484,5,489,0.38
6,HAILAKANDI,9,GULA AHMED MAZUMDER,Independent,138,0,138,0.11
6,HAILAKANDI,10,BINOY KUMAR ROY,Independent,119,7,126,0.1
6,HAILAKANDI,11,MUJIB AHMED CHOUDHURY,Independent,617,3,620,0.48
6,HAILAKANDI,12,SAIDUR RAHMAN BARBHUIYA,Independent,542,1,543,0.42
6,HAILAKANDI,13,HILAL UDDIN LASKAR,Independent,6517,66,6583,5.11
6,HAILAKANDI,14,NOTA,None of the Above,1058,5,1063,0.83
7,KATLICHERRA,1,SANJEEV ROY,Indian National Congress,2522,0,2522,1.87
7,KATLICHERRA,2,SUZAM UDDIN LASKAR,All India United Democratic Front,70721,0,70721,52.33
7,KATLICHERRA,3,SUBRATA KUMAR NATH,Bharatiya Janata Party,57999,0,57999,42.92
7,KATLICHERRA,4,RAM KUMAR NUNIA,Janata Dal  (United),586,0,586,0.43
7,KATLICHERRA,5,ACHAB UDDIN BARBHUIYA,Independent,173,0,173,0.13
7,KATLICHERRA,6,AFTAB UDDIN BARBHUIYA,Independent,175,0,175,0.13
7,KATLICHERRA,7,ABDUL BASIT LASKAR,Independent,93,0,93,0.07
7,KATLICHERRA,8,AHMED HUSSAIN BARBHUIYA,Independent,155,0,155,0.11
7,KATLICHERRA,9,JOHUR UDDIN TALUKDAR,Independent,131,0,131,0.1
7,KATLICHERRA,10,BADAR UDDIN LASKAR,Independent,80,0,80,0.06
7,KATLICHERRA,11,MOJMUL ISLAM LASKAR,Independent,188,0,188,0.14
7,KATLICHERRA,12,RAJESH PAUL,Independent,229,0,229,0.17
7,KATLICHERRA,13,LUTHFUR RAHMAN LASKAR,Independent,804,0,804,0.59
7,KATLICHERRA,14,SAHAB UDDIN LASKAR,Independent,594,0,594,0.44
7,KATLICHERRA,15,NOTA,None of the Above,688,0,688,0.51
8,ALGAPUR,1,Aftab Uddin Laskar,Asom Gana Parishad,7458,91,7549,5.59
8,ALGAPUR,2,Nijam Uddin Choudhury,All India United Democratic Front,66134,651,66785,49.46
8,ALGAPUR,3,Moon Swarnakar,Bharatiya Janata Party,48894,287,49181,36.42
8,ALGAPUR,4,Simu Das,All India Forward Bloc,549,3,552,0.41
8,ALGAPUR,5,Alim Uddin Laskar,Independent,135,1,136,0.1
8,ALGAPUR,6,Imadul Islam Laskar,Independent,93,2,95,0.07
8,ALGAPUR,7,Kaji Abdul Hakim,Independent,279,1,280,0.21
8,ALGAPUR,8,Gulzar Ahmed Barbhuiya,Independent,339,0,339,0.25
8,ALGAPUR,9,Jahanara Begum Mazumder,Independent,314,0,314,0.23
8,ALGAPUR,10,Daisy Roy,Independent,1588,13,1601,1.19
8,ALGAPUR,11,Badrul Islam Barbhuiya,Independent,1379,24,1403,1.04
8,ALGAPUR,12,Babul Kumar,Independent,2339,4,2343,1.74
8,ALGAPUR,13,Bulbul Alam Choudhury,Independent,534,0,534,0.4
8,ALGAPUR,14,Brojendra Chandra Das,Independent,466,0,466,0.35
8,ALGAPUR,15,Manoj Kumar Malakar,Independent,793,1,794,0.59
8,ALGAPUR,16,Raju Das,Independent,759,1,760,0.56
8,ALGAPUR,17,Raju Deb,Independent,224,0,224,0.17
8,ALGAPUR,18,Samin Ahmed Choudhury,Independent,634,0,634,0.47
8,ALGAPUR,19,Saleh Ahmed Mazumder,Independent,593,1,594,0.44
8,ALGAPUR,20,NOTA,None of the Above,433,9,442,0.33
9,SILCHAR,1,TAMAL KANTI BANIK,Indian National Congress,12754,0,12754,33.71
9,SILCHAR,2,DIPAYAN CHAKRABORTY,Bharatiya Janata Party,20917,0,20917,55.29
9,SILCHAR,3,DULALI CHAKRABORTY,SOCIALIST UNITY CENTRE OF INDIA (COMMUNIST),200,0,200,0.53
9,SILCHAR,4,PRASANTA LASKAR,Republican Party of India (A),44,0,44,0.12
9,SILCHAR,5,BISHWAY CHAMAK GOSWAMI,Bharatiya Gana Parishad,34,0,34,0.09
9,SILCHAR,6,RAJU SINHA,Hindusthan Nirman Dal,357,0,357,0.94
9,SILCHAR,7,ANUP DUTTA,Independent,50,0,50,0.13
9,SILCHAR,8,ANUPAM DEV,Independent,43,0,43,0.11
9,SILCHAR,9,DILIP KUMAR PAUL,Independent,2789,0,2789,7.37
9,SILCHAR,10,BAKTAR UDDIN MAZUMDER,Independent,47,0,47,0.12
9,SILCHAR,11,BAPPI PAUL,Independent,22,0,22,0.06
9,SILCHAR,12,BIJU CHANDA,Independent,24,0,24,0.06
9,SILCHAR,13,RUSNA BEGUM LASKAR,Independent,36,0,36,0.1
9,SILCHAR,14,SHANKAR CHAKRABORTY,Independent,80,0,80,0.21
9,SILCHAR,15,SHUVADIP DATTA,Independent,167,0,167,0.44
9,SILCHAR,16,NOTA,None of the Above,270,0,270,0.71
10,SONAI,1,AMINUL HAQUE LASKAR,Bharatiya Janata Party,35889,0,35889,37.01
10,SONAI,2,KARIM UDDIN BARBHUIYA,All India United Democratic Front,45188,0,45188,46.6
10,SONAI,3,M. SANTI KUMAR SINGHA,All India Trinamool Congress,1634,0,1634,1.69
10,SONAI,4,ANJAN KUMAR CHANDA,SOCIALIST UNITY CENTRE OF INDIA (COMMUNIST),188,0,188,0.19
10,SONAI,5,ANWAR HUSSAIN LASKAR,Samajwadi Party,321,0,321,0.33
10,SONAI,6,ABDUL MATLIB LASKAR,Independent,98,0,98,0.1
10,SONAI,7,ASHISH HALDAR,Independent,10344,0,10344,10.67
10,SONAI,8,ANAMUL HAQUE,Independent,457,0,457,0.47
10,SONAI,9,KARIM UDDIN BARBHUIYA,Independent,171,0,171,0.18
10,SONAI,10,DILIP KUMAR DAS,Independent,200,0,200,0.21
10,SONAI,11,MD NAZRUL ISLAM LASKAR,Independent,160,0,160,0.17
10,SONAI,12,BIJAN PAUL,Independent,538,0,538,0.55
10,SONAI,13,SHUKUMAR SONAR,Independent,328,0,328,0.34
10,SONAI,14,SAYAL AHMED BARBHUIYA,Independent,628,0,628,0.65
10,SONAI,15,NOTA,None of the Above,820,0,820,0.85
11,DHOLAI,1,KAMAKHYA PRASAD MALA,Indian National Congress,61868,308,62176,41.44
11,DHOLAI,2,PARIMAL SUKLA BAIDYA,Bharatiya Janata Party,81896,672,82568,55.03
11,DHOLAI,3,GOUR CHANDRA DAS,SOCIALIST UNITY CENTRE OF INDIA (COMMUNIST),1823,11,1834,1.22
11,DHOLAI,4,RAM RATAN DUSAD,Assam Jatiya Parishad,376,5,381,0.25
11,DHOLAI,5,ANANTA MOHAN ROY,Independent,355,1,356,0.24
11,DHOLAI,6,DIPAK RANJAN ROY,Independent,417,8,425,0.28
11,DHOLAI,7,PARIMAL DAS,Independent,746,4,750,0.5
11,DHOLAI,8,NOTA,None of the Above,1558,3,1561,1.04
12,UDHARBOND,1,AJIT SINGH,Indian National Congress,58674,386,59060,45.28
12,UDHARBOND,2,MIHIR KANTI SHOME,Bharatiya Janata Party,61175,570,61745,47.34
12,UDHARBOND,3,Aynul Hoque Laskar,Assam Jatiya Parishad,802,9,811,0.62
12,UDHARBOND,4,Debojyoti Bhattacharjee,Independent,276,5,281,0.22
12,UDHARBOND,5,Rahul Roy,Independent,5763,33,5796,4.44
12,UDHARBOND,6,Subrata Mazumder,Independent,540,4,544,0.42
12,UDHARBOND,7,Suman Das,Independent,705,5,710,0.54
12,UDHARBOND,8,NOTA,None of the Above,1483,11,1494,1.15
13,LAKHIPUR,1,Kaushik Rai,Bharatiya Janata Party,53721,0,53721,44.61
13,LAKHIPUR,2,Mukesh Pandey,Indian National Congress,41668,0,41668,34.6
13,LAKHIPUR,3,Alim Uddin Mazumder,Assam Jatiya Parishad,2923,0,2923,2.43
13,LAKHIPUR,4,Kshirode Karmakar,Independent,378,0,378,0.31
13,LAKHIPUR,5,Chiranjit Acharjee,Independent,627,0,627,0.52
13,LAKHIPUR,6,Thoiba Singha,Independent,19619,0,19619,16.29
13,LAKHIPUR,7,NOTA,None of the Above,1479,0,1479,1.23
14,BARKHOLA,1,AMALENDU DAS,Bharatiya Janata Party,56906,496,57402,46.12
14,BARKHOLA,2,MISBAHUL ISLAM LASKAR,Indian National Congress,63950,483,64433,51.77
14,BARKHOLA,3,MEHBUB RAHMAN BARBHUIYA,Assam Jatiya Parishad,774,2,776,0.62
14,BARKHOLA,4,NAZMUL HOQUE LASKAR,Independent,261,2,263,0.21
14,BARKHOLA,5,HIFZUR RAHMAN LASKAR,Independent,474,1,475,0.38
14,BARKHOLA,6,NOTA,None of the Above,1095,10,1105,0.89
15,KATIGORA,1,Khalil Uddin Mazumder,Indian National Congress,82610,0,82610,51.28
15,KATIGORA,2,Gautam Roy,Bharatiya Janata Party,75513,0,75513,46.88
15,KATIGORA,3,Abdul Odud Choudhury,Independent,474,0,474,0.29
15,KATIGORA,4,Junaid Ahmed Barbhuiya,Independent,194,0,194,0.12
15,KATIGORA,5,Nasir Uddin Barbhuiya,Independent,139,0,139,0.09
15,KATIGORA,6,Monsur Hassan Choudhury,Independent,196,0,196,0.12
15,KATIGORA,7,GMC SAHAB UDDIN AHMED,Independent,292,0,292,0.18
15,KATIGORA,8,Hilal Ahmed Talukder,Independent,562,0,562,0.35
15,KATIGORA,9,NOTA,None of the Above,1106,0,1106,0.69
16,HAFLONG,1,NANDITA GORLOSA,Bharatiya Janata Party,67119,678,67797,56.73
16,HAFLONG,2,NIRMAL LANGTHASA,Indian National Congress,48659,540,49199,41.16
16,HAFLONG,3,KHANDAN DAULAGUPU,Bhartiya Tribal Party,819,7,826,0.69
16,HAFLONG,4,LONGKI ENGHI,Janata Dal  (United),718,5,723,0.6
16,HAFLONG,5,NOTA,None of the Above,963,10,973,0.81
17,BOKAJAN,1,DAVID RENGMA,National People's Party,1466,6,1472,1.24
17,BOKAJAN,2,NUMAL MOMIN,Bharatiya Janata Party,60404,322,60726,51.05
17,BOKAJAN,3,RATON ENGTI,Indian National Congress,42655,186,42841,36.02
17,BOKAJAN,4,AMLONG INGTI,Communist Party of India  (Marxist-Leninist)  (Liberation),1568,4,1572,1.32
17,BOKAJAN,5,RAJENDRA RONGPI,Autonomous State Demand Committee,3388,22,3410,2.87
17,BOKAJAN,6,SANJAY KEMPRAI,Bhartiya Tribal Party,710,0,710,0.6
17,BOKAJAN,7,SEMSON TERON,Independent,6602,28,6630,5.57
17,BOKAJAN,8,NOTA,None of the Above,1576,8,1584,1.33
18,HOWRAGHAT,1,Chomang Teron,National People's Party,1108,10,1118,1.08
18,HOWRAGHAT,2,Darsing Ronghang,Bharatiya Janata Party,57369,558,57927,55.74
18,HOWRAGHAT,3,Sanjeeb Teron,Indian National Congress,26014,230,26244,25.25
18,HOWRAGHAT,4,Chandra Kanta Terang,Autonomous State Demand Committee,5059,39,5098,4.91
18,HOWRAGHAT,5,Pradip Tokbi,Janata Dal  (United),638,1,639,0.61
18,HOWRAGHAT,6,Rabi Kumar Phangcho,Communist Party of India  (Marxist-Leninist)  (Liberation),1819,14,1833,1.76
18,HOWRAGHAT,7,Rakesh Ronghang,Independent,715,3,718,0.69
18,HOWRAGHAT,8,Suren Kramsa,Independent,8958,32,8990,8.65
18,HOWRAGHAT,9,NOTA,None of the Above,1349,6,1355,1.3
19,DIPHU,1,Sum Ronghang,Indian National Congress,27969,0,27969,24.24
19,DIPHU,2,Bidya Sing Engleng,Bharatiya Janata Party,58549,0,58549,50.74
19,DIPHU,3,Rajen Timung,National People's Party,1022,0,1022,0.89
19,DIPHU,4,Ranjit Kramsa,Communist Party of India  (Marxist-Leninist)  (Liberation),1084,0,1084,0.94
19,DIPHU,5,Hemsing Tisso,Autonomous State Demand Committee,5801,0,5801,5.03
19,DIPHU,6,Jones Ingti Kathar,Independent,17283,0,17283,14.98
19,DIPHU,7,Dilip Sing Bey,Independent,661,0,661,0.57
19,DIPHU,8,Bhogeswar Shyam,Independent,556,0,556,0.48
19,DIPHU,9,Rohili Tokbipi,Independent,769,0,769,0.67
19,DIPHU,10,NOTA,None of the Above,1693,0,1693,1.47
20,BAITHALANGSO,1,Augustine Enghee,Indian National Congress,36226,52,36278,22.24
20,BAITHALANGSO,2,Rupsing Teron,Bharatiya Janata Party,89577,138,89715,55
20,BAITHALANGSO,3,Welcome Teron,National People's Party,1874,7,1881,1.15
20,BAITHALANGSO,4,Sima Engtipi,Janata Dal  (United),942,0,942,0.58
20,BAITHALANGSO,5,Sarsing Engleng,Independent,11537,10,11547,7.08
20,BAITHALANGSO,6,Pratima Engheepi,Independent,1478,1,1479,0.91
20,BAITHALANGSO,7,Bikram Hanse,Independent,17955,10,17965,11.01
20,BAITHALANGSO,8,Rina Beypi,Independent,1218,5,1223,0.75
20,BAITHALANGSO,9,NOTA,None of the Above,2082,0,2082,1.28
21,MANKACHAR,1,AMINUL ISLAM,National People's Party,1911,4,1915,0.95
21,MANKACHAR,2,ZABED ISLAM,Asom Gana Parishad,66030,549,66579,32.94
21,MANKACHAR,3,MD. AMINUL ISLAM,All India United Democratic Front,122748,743,123491,61.09
21,MANKACHAR,4,SAYED HASSAN IMAN,Janata Dal  (United),889,2,891,0.44
21,MANKACHAR,5,SHAHIDUR ALAM,SOCIALIST UNITY CENTRE OF INDIA (COMMUNIST),659,1,660,0.33
21,MANKACHAR,6,ZAMER ALI,Independent,4125,4,4129,2.04
21,MANKACHAR,7,MONOWAR HUSSAIN,Independent,2593,6,2599,1.29
21,MANKACHAR,8,RUKUNUR ZAMAN,Independent,981,2,983,0.49
21,MANKACHAR,9,NOTA,None of the Above,897,1,898,0.44
22,SALMARA SOUTH,1,ASADUL ISLAM,Bharatiya Janata Party,6321,0,6321,5.38
22,SALMARA SOUTH,2,WAZED ALI CHOUDHURY,Indian National Congress,97336,0,97336,82.86
22,SALMARA SOUTH,3,JENAT MOLLAH,Nationalist Congress Party,971,0,971,0.83
22,SALMARA SOUTH,4,ABDUS SOBUR MIAH,SOCIALIST UNITY CENTRE OF INDIA (COMMUNIST),1016,0,1016,0.86
22,SALMARA SOUTH,5,TALEB ALI,Janata Dal  (United),158,0,158,0.13
22,SALMARA SOUTH,6,NURAL ISLAM,Rashtriya Ulama Council,801,0,801,0.68
22,SALMARA SOUTH,7,NOZRUL ISLAM,Independent,1280,0,1280,1.09
22,SALMARA SOUTH,8,NURUL ISLAM MOLLAH,Independent,7711,0,7711,6.56
22,SALMARA SOUTH,9,FOZLUL HOQUE CHOUDHURY,Independent,1242,0,1242,1.06
22,SALMARA SOUTH,10,NOTA,None of the Above,634,0,634,0.54
23,DHUBRI,1,DR. DEBAMOY SANYAL,Bharatiya Janata Party,45347,236,45583,26.42
23,DHUBRI,2,NAZRUL HOQUE,All India United Democratic Front,120426,244,120670,69.94
23,DHUBRI,3,AZAD ALI SHEIKH,Assam Jatiya Parishad,1662,6,1668,0.97
23,DHUBRI,4,TAHABIL ALOM SARKAR,Janata Dal  (United),260,1,261,0.15
23,DHUBRI,5,DEWAN HABIBUR RAHMAN,SOCIALIST UNITY CENTRE OF INDIA (COMMUNIST),316,0,316,0.18
23,DHUBRI,6,MOBARAK HUSSAIN,Independent,484,5,489,0.28
23,DHUBRI,7,RASUL HOQUE,Independent,2088,3,2091,1.21
23,DHUBRI,8,NOTA,None of the Above,1442,4,1446,0.84
24,GAURIPUR,1,NIZANUR RAHMAN,All India United Democratic Front,60407,0,60407,61.99
24,GAURIPUR,2,BANENDRA KUMAR MUSHAHARY,Bharatiya Janata Party,32443,0,32443,33.29
24,GAURIPUR,3,JABBAR ALI,Janata Dal  (United),351,0,351,0.36
24,GAURIPUR,4,MIR HUSSAIN SARKAR,Republican Party of India (A),535,0,535,0.55
24,GAURIPUR,5,AKUL BARMAN,Independent,190,0,190,0.19
24,GAURIPUR,6,ABDUR REZZAK HOSSAIN,Independent,762,0,762,0.78
24,GAURIPUR,7,KHAGENDRA NATH RAY,Independent,561,0,561,0.58
24,GAURIPUR,8,NIRANJAN PRODHANI,Independent,429,0,429,0.44
24,GAURIPUR,9,MD. MOHIBUL HAQUE,Independent,781,0,781,0.8
24,GAURIPUR,10,NOTA,None of the Above,984,0,984,1.01
25,GOLAKGANJ,1,ASHWINI RAY SARKAR,Bharatiya Janata Party,32666,0,32666,38.29
25,GOLAKGANJ,2,ABDUS SOBAHAN ALI SARKAR,Indian National Congress,43073,0,43073,50.49
25,GOLAKGANJ,3,SAHIDUR RAHMAN,All India Trinamool Congress,569,0,569,0.67
25,GOLAKGANJ,4,ATIKUR RAHMAN,Assam Jatiya Parishad,179,0,179,0.21
25,GOLAKGANJ,5,MOMINUR ALOM,Rashtriya Ulama Council,174,0,174,0.2
25,GOLAKGANJ,6,ABU TAHER BEPARI,Independent,7650,0,7650,8.97
25,GOLAKGANJ,7,NILIMOY PRODHANI,Independent,451,0,451,0.53
25,GOLAKGANJ,8,NOTA,None of the Above,541,0,541,0.63
26,BILASIPARA WEST,1,DR. ABU BAKAR SIDDIQUE,Bharatiya Janata Party,26907,147,27054,16.78
26,BILASIPARA WEST,2,ABDUR REZZAK SHEIKH,All India Trinamool Congress,6422,35,6457,4.01
26,BILASIPARA WEST,3,HAFIZ BASHIR AHMED,All India United Democratic Front,90166,363,90529,56.16
26,BILASIPARA WEST,4,AKBAR ALI MONDAL,The National Road Map Party of India,1624,3,1627,1.01
26,BILASIPARA WEST,5,DR. ANES AHMED,Assam Jatiya Parishad,1511,11,1522,0.94
26,BILASIPARA WEST,6,ALI AKBAR MIAH,Independent,30670,101,30771,19.09
26,BILASIPARA WEST,7,IFTARUL ISLAM PARAMANIK,Independent,1921,5,1926,1.19
26,BILASIPARA WEST,8,NOTA,None of the Above,1298,8,1306,0.81
27,BILASIPARA EAST,1,ASHOK KUMAR SINGHI,Bharatiya Janata Party,66325,443,66768,34.11
27,BILASIPARA EAST,2,SAMSUL HUDA,All India United Democratic Front,115714,354,116068,59.3
27,BILASIPARA EAST,3,ABDUL MONNAF PRAMANIK,Janata Dal  (United),907,1,908,0.46
27,BILASIPARA EAST,4,KANULAL DAS,Assam Jatiya Parishad,3338,37,3375,1.72
27,BILASIPARA EAST,5,PRODIP CHANDRA ROY,Republican Party of India,397,6,403,0.21
27,BILASIPARA EAST,6,MOZNUR RAHMAN,Independent,474,4,478,0.24
27,BILASIPARA EAST,7,MOYNUL HOQUE,Independent,369,2,371,0.19
27,BILASIPARA EAST,8,ABDUL JABBAR,Independent,480,3,483,0.25
27,BILASIPARA EAST,9,JITENDRA NATH ADHIKARY,Independent,631,3,634,0.32
27,BILASIPARA EAST,10,MOMINUR ISLAM,Independent,2888,3,2891,1.48
27,BILASIPARA EAST,11,MOSHLEM UDDIN CHOUDHURY,Independent,1657,0,1657,0.85
27,BILASIPARA EAST,12,NOTA,None of the Above,1706,2,1708,0.87
28,GOSSAIGAON,1,Majendra Narzary,Bodoland Peoples Front,69780,627,70407,45.19
28,GOSSAIGAON,2,Saidur Islam,The National Road Map Party of India,1280,4,1284,0.82
28,GOSSAIGAON,3,Ratan Hasda,Janata Dal  (United),1030,26,1056,0.68
28,GOSSAIGAON,4,Somnath Narzary,"United People’s Party, Liberal",59499,565,60064,38.55
28,GOSSAIGAON,5,Abdul Samad Choudhury,Independent,3810,21,3831,2.46
28,GOSSAIGAON,6,Uttam Kumar Talukdar,Independent,1101,15,1116,0.72
28,GOSSAIGAON,7,Osman Goni SK,Independent,794,3,797,0.51
28,GOSSAIGAON,8,Khairul Anam Khandakar,Independent,9150,24,9174,5.89
28,GOSSAIGAON,9,Riajul Hoque,Independent,1407,5,1412,0.91
28,GOSSAIGAON,10,Ruhit Basumatary,Independent,866,6,872,0.56
28,GOSSAIGAON,11,Surjyanath Tudu,Independent,3966,16,3982,2.56
28,GOSSAIGAON,12,NOTA,None of the Above,1792,9,1801,1.16
29,KOKRAJHAR WEST,1,RABIRAM NARZARY,Bodoland Peoples Front,76826,683,77509,49.68
29,KOKRAJHAR WEST,2,MANARANJAN BRAHMA,"United People’s Party, Liberal",64593,845,65438,41.94
29,KOKRAJHAR WEST,3,RANENDRA KOCH,Janata Dal  (United),901,37,938,0.6
29,KOKRAJHAR WEST,4,RAJENDRA MUSHAHARY,The National Road Map Party of India,827,15,842,0.54
29,KOKRAJHAR WEST,5,KAUSHIK MOHAN BRAHMA,Independent,6636,26,6662,4.27
29,KOKRAJHAR WEST,6,GAUTAM BARO,Independent,1156,10,1166,0.75
29,KOKRAJHAR WEST,7,RANJAY KR. BRAHMA,Independent,1821,11,1832,1.17
29,KOKRAJHAR WEST,8,NOTA,None of the Above,1626,19,1645,1.05
30,KOKRAJHAR EAST,1,PRAMILA RANI BRAHMA,Bodoland Peoples Front,62922,498,63420,41.11
30,KOKRAJHAR EAST,2,MIJING BRAHMA,Voters Party  International,1240,36,1276,0.83
30,KOKRAJHAR EAST,3,LAWRENCE ISLARY,"United People’s Party, Liberal",82817,698,83515,54.14
30,KOKRAJHAR EAST,4,MANAJ KUMAR BRAHMA,Independent,3229,35,3264,2.12
30,KOKRAJHAR EAST,5,SHRI SAILENDRA NATH BRAHMA,Independent,888,9,897,0.58
30,KOKRAJHAR EAST,6,NOTA,None of the Above,1865,18,1883,1.22
31,SIDLI,1,CHANDAN BRAHMA,Bodoland Peoples Front,65413,354,65767,38.27
31,SIDLI,2,JOYANTA BASUMATARY,"United People’s Party, Liberal",96550,537,97087,56.5
31,SIDLI,3,RANJAY KUMAR BRAHMA,Janata Dal  (United),1536,20,1556,0.91
31,SIDLI,4,JISOYA CHAMPRAMARY,Independent,3070,14,3084,1.79
31,SIDLI,5,SMRITI BASUMATARY,Independent,1828,22,1850,1.08
31,SIDLI,6,NOTA,None of the Above,2469,16,2485,1.45
32,BONGAIGAON,1,PRABHAT BAISNAB,National People's Party,1595,51,1646,1.07
32,BONGAIGAON,2,PHANI BHUSAN CHOUDHURY,Asom Gana Parishad,82036,764,82800,53.9
32,BONGAIGAON,3,SHANKAR PRASAD RAY,Indian National Congress,44386,247,44633,29.05
32,BONGAIGAON,4,DIPU CHOUDHURY,Assam Jatiya Parishad,13872,116,13988,9.1
32,BONGAIGAON,5,SANTANU MUKHERJEE,Political Justice Party,2254,12,2266,1.47
32,BONGAIGAON,6,SABENDRA BASUMATARY,Voters Party  International,927,25,952,0.62
32,BONGAIGAON,7,SRI SUJIT KUMAR ROY,Bharatiya Gana Parishad,2163,21,2184,1.42
32,BONGAIGAON,8,KAILASH DAS,Independent,1807,3,1810,1.18
32,BONGAIGAON,9,GAUTAM DUTTA,Independent,1167,5,1172,0.76
32,BONGAIGAON,10,NOTA,None of the Above,2149,30,2179,1.42
33,BIJNI,1,AJOY KUMAR RAY,Bharatiya Janata Party,44909,824,45733,32.69
33,BIJNI,2,KAMALSHING NARZARY,Bodoland Peoples Front,43995,735,44730,31.97
33,BIJNI,3,NANDADEB BRAHMA,Voters Party  International,482,21,503,0.36
33,BIJNI,4,PHANIN BORO,"United People’s Party, Liberal",34899,683,35582,25.43
33,BIJNI,5,RUPAM KUMAR DAS,Assam Jatiya Parishad,9766,185,9951,7.11
33,BIJNI,6,ABDUL AWAL PARAMANIK,Independent,657,12,669,0.48
33,BIJNI,7,SOLEMAN MONDAL,Independent,548,23,571,0.41
33,BIJNI,8,BAHARUL ISLAM NAGORI,Independent,777,11,788,0.56
33,BIJNI,9,NOTA,None of the Above,1368,20,1388,0.99
34,ABHAYAPURI NORTH,1,ABDUL BATIN KHANDAKAR,Indian National Congress,92698,578,93276,58.58
34,ABHAYAPURI NORTH,2,ASRAFUL ISLAM,All India Trinamool Congress,1545,22,1567,0.98
34,ABHAYAPURI NORTH,3,BHUPEN ROY,Asom Gana Parishad,59637,858,60495,38
34,ABHAYAPURI NORTH,4,AJANTA BARUAH,Assam Jatiya Parishad,1173,91,1264,0.79
34,ABHAYAPURI NORTH,5,SHYAM RAJ RABHA,Janata Dal  (United),349,17,366,0.23
34,ABHAYAPURI NORTH,6,JAHIDUL ISLAM,Independent,406,7,413,0.26
34,ABHAYAPURI NORTH,7,SHEIKH ABDULLAH,Independent,808,3,811,0.51
34,ABHAYAPURI NORTH,8,NOTA,None of the Above,1015,10,1025,0.64
35,ABHAYAPURI SOUTH,1,PURNENDU BANIKYA,Asom Gana Parishad,65130,739,65869,35.59
35,ABHAYAPURI SOUTH,2,PRADIP SARKAR,Indian National Congress,112341,613,112954,61.04
35,ABHAYAPURI SOUTH,3,KAUSHIK RANJAN DAS,Independent,2090,15,2105,1.14
35,ABHAYAPURI SOUTH,4,ROMONATH MONDAL,Independent,2469,20,2489,1.34
35,ABHAYAPURI SOUTH,5,NOTA,None of the Above,1617,25,1642,0.89
36,DUDHNAI,1,MANOJ KUMAR BASUMATARY (MUNITION),National People's Party,1180,10,1190,0.66
36,DUDHNAI,2,JADAB SWARGIARY,Indian National Congress,78347,204,78551,43.46
36,DUDHNAI,3,SHYAMJIT RABHA,Bharatiya Janata Party,76995,280,77275,42.75
36,DUDHNAI,4,DIGANTA  KUMAR  RABHA,Janata Dal  (United),1257,13,1270,0.7
36,DUDHNAI,5,BORJIT BORO,Voters Party  International,2451,11,2462,1.36
36,DUDHNAI,6,ANIL RABHA,Independent,675,3,678,0.38
36,DUDHNAI,7,DIPAK KUMAR RABHA,Independent,16443,44,16487,9.12
36,DUDHNAI,8,BATSRANG G. MOMIN,Independent,1470,5,1475,0.82
36,DUDHNAI,9,NOTA,None of the Above,1362,5,1367,0.76
37,GOALPARA EAST,1,ABUL KALAM RASHEED ALAM,Indian National Congress,70381,0,70381,55.72
37,GOALPARA EAST,2,KOFIL UDDIN AHMED,Nationalist Congress Party,603,0,603,0.48
37,GOALPARA EAST,3,JYOTISH DAS,Asom Gana Parishad,46712,0,46712,36.98
37,GOALPARA EAST,4,RINKU MAZUMDAR,National People's Party,1063,0,1063,0.84
37,GOALPARA EAST,5,SHEIKH MD. JIAUL HOQUE,All India Trinamool Congress,460,0,460,0.36
37,GOALPARA EAST,6,IMDAD HUSSAIN,Assam Jatiya Parishad,683,0,683,0.54
37,GOALPARA EAST,7,CHITRALEKHA DAS,SOCIALIST UNITY CENTRE OF INDIA (COMMUNIST),236,0,236,0.19
37,GOALPARA EAST,8,FARUK AHMED,All India Minorities Front,510,0,510,0.4
37,GOALPARA EAST,9,MAZIBAR RAHMAN,Republican Party of India (A),318,0,318,0.25
37,GOALPARA EAST,10,AMINUL HOQUE,Independent,2130,0,2130,1.69
37,GOALPARA EAST,11,DHARMA NARAYAN NATH,Independent,727,0,727,0.58
37,GOALPARA EAST,12,MEHBUBAR RAHMAN,Independent,468,0,468,0.37
37,GOALPARA EAST,13,RANJAN SARKAR,Independent,891,0,891,0.71
37,GOALPARA EAST,14,NOTA,None of the Above,1135,0,1135,0.9
38,GOALPARA WEST,1,ABDUR RASHID MANDAL,Indian National Congress,83414,199,83613,56.74
38,GOALPARA WEST,2,ABDUL BATEN SIKDAR,National People's Party,1237,5,1242,0.84
38,GOALPARA WEST,3,NIZAM UDDIN,All India Trinamool Congress,822,3,825,0.56
38,GOALPARA WEST,4,SHEIKH SHAH ALOM,Asom Gana Parishad,33493,129,33622,22.82
38,GOALPARA WEST,5,ABTABUL AMBIA MOLLAH,Janata Dal  (United),268,5,273,0.19
38,GOALPARA WEST,6,SAFIOR RAHMAN,Assam Jatiya Parishad,607,13,620,0.42
38,GOALPARA WEST,7,PUSPADHAR NATH,Voters Party  International,1153,7,1160,0.79
38,GOALPARA WEST,8,MOHIBUL ISLAM,SOCIALIST UNITY CENTRE OF INDIA (COMMUNIST),780,6,786,0.53
38,GOALPARA WEST,9,CHAN ALI MIAH,Independent,17679,41,17720,12.03
38,GOALPARA WEST,10,JAHANGIR ALOM MONDAL,Independent,514,1,515,0.35
38,GOALPARA WEST,11,JEHIRUL ISLAM,Independent,535,2,537,0.36
38,GOALPARA WEST,12,DELOWAR HUSSAIN,Independent,486,1,487,0.33
38,GOALPARA WEST,13,NABAJYOTI RABHA,Independent,3630,32,3662,2.49
38,GOALPARA WEST,14,PABITRA KUMAR NATH,Independent,1080,3,1083,0.73
38,GOALPARA WEST,15,NOTA,None of the Above,1200,10,1210,0.82
39,JALESWAR,1,Aftab Uddin Mollah,Indian National Congress,75826,200,76026,50.75
39,JALESWAR,2,Osman Goni,Bharatiya Janata Party,14015,38,14053,9.38
39,JALESWAR,3,Khurshid Mirza Ashikur Rahman,All India Trinamool Congress,1842,5,1847,1.23
39,JALESWAR,4,DR. Reza M A Amin,All India United Democratic Front,53950,96,54046,36.08
39,JALESWAR,5,Osman Goni Mollah,SOCIALIST UNITY CENTRE OF INDIA (COMMUNIST),564,2,566,0.38
39,JALESWAR,6,Roshidul Hoque,Assam Jatiya Parishad,913,2,915,0.61
39,JALESWAR,7,Akheruzzaman Mollah,Independent,754,0,754,0.5
39,JALESWAR,8,Mujaharul Islam,Independent,626,0,626,0.42
39,JALESWAR,9,NOTA,None of the Above,968,2,970,0.65
40,SORBHOG,1,MANORANJAN TALUKDAR,Communist Party of India  (Marxist),95638,0,95638,50.27
40,SORBHOG,2,SANKAR CHANDRA DAS,Bharatiya Janata Party,85248,0,85248,44.81
40,SORBHOG,3,DEVANANDA DAS,Janata Dal  (United),617,0,617,0.32
40,SORBHOG,4,PRAKASH BRAHMA,Republican Party of India (Athawale),593,0,593,0.31
40,SORBHOG,5,MATIAR RAHMAN,The National Road Map Party of India,396,0,396,0.21
40,SORBHOG,6,SANTANU MUKHERJEE,Political Justice Party,850,0,850,0.45
40,SORBHOG,7,ABDUL HANNAN,Independent,790,0,790,0.42
40,SORBHOG,8,IKBAL HUSSAIN,Independent,869,0,869,0.46
40,SORBHOG,9,DWIPEN BARMAN,Independent,2416,0,2416,1.27
40,SORBHOG,10,FAIZAN NESSA,Independent,935,0,935,0.49
40,SORBHOG,11,NOTA,None of the Above,1880,0,1880,0.99
41,BHABANIPUR,1,PHANIDHAR TALUKDAR,All India United Democratic Front,53995,429,54424,45.04
41,BHABANIPUR,2,RANJIT DEKA,Asom Gana Parishad,49870,512,50382,41.7
41,BHABANIPUR,3,ANOWAR UDDIN AHMED,Republican Party of India (Athawale),433,10,443,0.37
41,BHABANIPUR,4,SATYA CHANDRA ARJYA,Bharatiya Gana Parishad,329,21,350,0.29
41,BHABANIPUR,5,HASEN ALI,Voters Party  International,509,5,514,0.43
41,BHABANIPUR,6,ABUL KALAM AZAD,Independent,5020,49,5069,4.2
41,BHABANIPUR,7,KAMAL KUMAR MEDHI,Independent,3070,27,3097,2.56
41,BHABANIPUR,8,SUBAN ALI,Independent,385,1,386,0.32
41,BHABANIPUR,9,BINOY KHERKATARY,Independent,1497,31,1528,1.26
41,BHABANIPUR,10,MAKHAN SWARGIARY,Independent,1258,25,1283,1.06
41,BHABANIPUR,11,MD. RAHMAN ALI,Independent,966,12,978,0.81
41,BHABANIPUR,12,RUHUL AMIN,Independent,1385,2,1387,1.15
41,BHABANIPUR,13,NOTA,None of the Above,981,10,991,0.82
42,PATACHARKUCHI,1,RANJEET KUMAR DASS,Bharatiya Janata Party,76530,0,76530,71.69
42,PATACHARKUCHI,2,SANTANU SARMA,Indian National Congress,17261,0,17261,16.17
42,PATACHARKUCHI,3,KRISHNAMANI DAS,Republican Party of India (Athawale),556,0,556,0.52
42,PATACHARKUCHI,4,PABINDRA DEKA,Assam Jatiya Parishad,9319,0,9319,8.73
42,PATACHARKUCHI,5,CHAKRA PANI MEDHI,Independent,1492,0,1492,1.4
42,PATACHARKUCHI,6,NOTA,None of the Above,1599,0,1599,1.5
43,BARPETA,1,ABDUR RAHIM AHMED,Indian National Congress,79187,0,79187,57.99
43,BARPETA,2,Gunindra Nath Das,Asom Gana Parishad,53824,0,53824,39.41
43,BARPETA,3,SIRAJUL HOQUE,Rashtriya Ulama Council,531,0,531,0.39
43,BARPETA,4,Pintu Ghosh,Political Justice Party,578,0,578,0.42
43,BARPETA,5,Shyamal Kr. Mandal,Janata Dal  (United),312,0,312,0.23
43,BARPETA,6,SHAFIQUL ISLAM,The National Road Map Party of India,749,0,749,0.55
43,BARPETA,7,NOTA,None of the Above,1377,0,1377,1.01
44,JANIA,1,Abdul Jalil Talukdar,All India Trinamool Congress,569,0,569,0.62
44,JANIA,2,Rafiqul Islam,All India United Democratic Front,80432,0,80432,86.98
44,JANIA,3,Shahidul Islam,Bharatiya Janata Party,5247,0,5247,5.67
44,JANIA,4,Zinnat Ali,The National Road Map Party of India,227,0,227,0.25
44,JANIA,5,Mazidul Islam,National Republican Congress,94,0,94,0.1
44,JANIA,6,Shukur Ali,Assam Jatiya Parishad,360,0,360,0.39
44,JANIA,7,Sheikh Jamsedur Rahman,Janata Dal  (United),80,0,80,0.09
44,JANIA,8,Arshad Ahmed,Independent,398,0,398,0.43
44,JANIA,9,Ashraful Islam,Independent,2774,0,2774,3
44,JANIA,10,Inumani Begum,Independent,279,0,279,0.3
44,JANIA,11,Faruk Khan,Independent,752,0,752,0.81
44,JANIA,12,Raizuddin,Independent,846,0,846,0.91
44,JANIA,13,NOTA,None of the Above,415,0,415,0.45
45,BAGHBAR,1,Rajib Ahmed,All India United Democratic Front,65338,77,65415,43.24
45,BAGHBAR,2,Sherman Ali Ahmed,Indian National Congress,79245,112,79357,52.46
45,BAGHBAR,3,Hasinara Khatun,Bharatiya Janata Party,3018,20,3038,2.01
45,BAGHBAR,4,Abdul Aziz,Voters Party  International,612,1,613,0.41
45,BAGHBAR,5,Salim Khan,Bhartiya Rashtrawadi Party,170,0,170,0.11
45,BAGHBAR,6,Jahidul Islam,Janata Dal  (United),158,0,158,0.1
45,BAGHBAR,7,Moshwaraf Hussein,The National Road Map Party of India,408,1,409,0.27
45,BAGHBAR,8,Rejaul Karim,Republican Party of India (Athawale),617,0,617,0.41
45,BAGHBAR,9,Lil Chan Uddin,Republican Party of India (A),272,0,272,0.18
45,BAGHBAR,10,Afil Uddin Talukdar,Independent,486,1,487,0.32
45,BAGHBAR,11,NOTA,None of the Above,737,3,740,0.49
46,SARUKHETRI,1,KALPANA PATOWARY,Asom Gana Parishad,47272,232,47504,26.56
46,SARUKHETRI,2,SAYED JEHERUL ISLAM,All India Trinamool Congress,1082,15,1097,0.61
46,SARUKHETRI,3,JAKIR HUSSAIN SIKDAR,Indian National Congress,76669,376,77045,43.07
46,SARUKHETRI,4,MINAKSHI RAHMAN,All India United Democratic Front,44577,228,44805,25.05
46,SARUKHETRI,5,AJIDUL ISLAM,Republican Party of India (A),544,4,548,0.31
46,SARUKHETRI,6,NAJRUL ISLAM,Janata Party,447,5,452,0.25
46,SARUKHETRI,7,NABAB MEZBAHUL ALAM,Janata Dal  (United),194,0,194,0.11
46,SARUKHETRI,8,MANIK CHANDRA BARO,Assam Jatiya Parishad,3062,31,3093,1.73
46,SARUKHETRI,9,SHAHJAHAN ALI,The National Road Map Party of India,711,0,711,0.4
46,SARUKHETRI,10,HALIMA KHATUN,SOCIALIST UNITY CENTRE OF INDIA (COMMUNIST),462,1,463,0.26
46,SARUKHETRI,11,BINAD ALI,Independent,922,1,923,0.52
46,SARUKHETRI,12,MATIAR RAHMAN,Independent,778,2,780,0.44
46,SARUKHETRI,13,NOTA,None of the Above,1260,5,1265,0.71
47,CHENGA,1,ABDUL GONI,All India Trinamool Congress,1612,5,1617,1.26
47,CHENGA,2,ASHRAFUL HUSSAIN,All India United Democratic Front,75108,204,75312,58.83
47,CHENGA,3,RABIUL HUSSAIN,Asom Gana Parishad,23263,110,23373,18.26
47,CHENGA,4,SUKUR ALI AHMED,Indian National Congress,22498,75,22573,17.63
47,CHENGA,5,GIAS UDDIN AHMED,Assam Jatiya Parishad,728,5,733,0.57
47,CHENGA,6,JASHIM KHAN,Voters Party  International,469,0,469,0.37
47,CHENGA,7,SEKH NURUL ALAM,Republican Party of India (Athawale),352,0,352,0.27
47,CHENGA,8,RUPDHAN AHMED,Bahujan Maha Party,1288,2,1290,1.01
47,CHENGA,9,ABUL HASHEM,Independent,427,2,429,0.34
47,CHENGA,10,ABDUR RAHIM ALI,Independent,375,0,375,0.29
47,CHENGA,11,NURUL AMIN,Independent,787,1,788,0.62
47,CHENGA,12,NOTA,None of the Above,695,1,696,0.54
48,BOKO,1,GOPI NATH DAS,All India Trinamool Congress,12542,29,12571,6.13
48,BOKO,2,JYOTI PRASAD DAS,Asom Gana Parishad,67985,162,68147,33.23
48,BOKO,3,NANDITA DAS,Indian National Congress,120504,109,120613,58.82
48,BOKO,4,NOTA,None of the Above,3723,12,3735,1.82
49,CHAYGAON,1,DR. KAMALA KANTA KALITA,Asom Gana Parishad,65756,64,65820,39.5
49,CHAYGAON,2,REKIBUDDIN AHMED,Indian National Congress,93826,38,93864,56.32
49,CHAYGAON,3,DEBAJIT ADHIKARI,Assam Jatiya Parishad,2476,5,2481,1.49
49,CHAYGAON,4,NURUL ISLAM,Rashtriya Lok Samta Party,360,0,360,0.22
49,CHAYGAON,5,SHYAMAL DUTTA,Bharatiya Gana Parishad,689,1,690,0.41
49,CHAYGAON,6,AZMAL HOQUE,Independent,577,1,578,0.35
49,CHAYGAON,7,NOIMUDDIN AHMED,Independent,535,0,535,0.32
49,CHAYGAON,8,DR. FARUK AHMED BHUYAN,Independent,834,0,834,0.5
49,CHAYGAON,9,NOTA,None of the Above,1484,3,1487,0.89
50,PALASBARI,1,JATIN MALI,Indian National Congress,27260,60,27320,20.72
50,PALASBARI,2,HEMANGA THAKURIA,Bharatiya Janata Party,68196,115,68311,51.81
50,PALASBARI,3,PANKAJ LOCHAN GOSWAMI,Assam Jatiya Parishad,28595,46,28641,21.72
50,PALASBARI,4,ANIL BORO,Independent,2297,9,2306,1.75
50,PALASBARI,5,JURI MALI,Independent,1724,6,1730,1.31
50,PALASBARI,6,MUKUT KALITA,Independent,1014,3,1017,0.77
50,PALASBARI,7,MUNMI DUTTA,Independent,1091,3,1094,0.83
50,PALASBARI,8,NOTA,None of the Above,1425,2,1427,1.08
51,JALUKBARI,1,ROMEN CHANDRA BORTHAKUR,Indian National Congress,28788,63,28851,17.07
51,JALUKBARI,2,HIMANTA BISWA SARMA,Bharatiya Janata Party,130232,530,130762,77.39
51,JALUKBARI,3,NABA KUMAR NATH,Independent,1211,7,1218,0.72
51,JALUKBARI,4,MOINUL HOQUE,Independent,1137,4,1141,0.68
51,JALUKBARI,5,HEMANTA KUMAR SUT,Independent,4834,4,4838,2.86
51,JALUKBARI,6,NOTA,None of the Above,2150,7,2157,1.28
52,DISPUR,1,ATUL BORA,Bharatiya Janata Party,99213,0,99213,64.96
52,DISPUR,2,MANJIT MAHANTA,Indian National Congress,35217,0,35217,23.06
52,DISPUR,3,HRIDAYANANDA GOGOI,Nationalist Congress Party,584,0,584,0.38
52,DISPUR,4,PALLABI RABHA,Janata Dal  (United),412,0,412,0.27
52,DISPUR,5,PRINCE FAIZUL HAQUE,Assam Jatiya Parishad,8913,0,8913,5.84
52,DISPUR,6,SUKANTA MAZUMDAR,Bharatiya Gana Parishad,190,0,190,0.12
52,DISPUR,7,SONAMONI DAS,Lok Jan Shakti Party,287,0,287,0.19
52,DISPUR,8,CHARAN CHANDRA DEKA,Independent,1212,0,1212,0.79
52,DISPUR,9,NITUL DAS,Independent,218,0,218,0.14
52,DISPUR,10,PALLABI DOLEY,Independent,394,0,394,0.26
52,DISPUR,11,BISWAJIT NATH,Independent,434,0,434,0.28
52,DISPUR,12,SHAILEN KALITA,Independent,2212,0,2212,1.45
52,DISPUR,13,HEMENDRA NATH DEKA,Independent,429,0,429,0.28
52,DISPUR,14,NOTA,None of the Above,3012,0,3012,1.97
53,GAUHATI EAST,1,ASHIMA BARDOLOI,Indian National Congress,19721,0,19721,18.11
53,GAUHATI EAST,2,RAJ PRASAD SAIKIA,National People's Party,388,0,388,0.36
53,GAUHATI EAST,3,SIDDHARTHA BHATTACHARYA,Bharatiya Janata Party,74895,0,74895,68.77
53,GAUHATI EAST,4,ADIP KUMAR PHUKAN,Assam Jatiya Parishad,10010,0,10010,9.19
53,GAUHATI EAST,5,PRANAB JYOTI DAS,Republican Party of India (Athawale),149,0,149,0.14
53,GAUHATI EAST,6,BAPI AICH,Bharatiya Gana Parishad,174,0,174,0.16
53,GAUHATI EAST,7,BHUPEN SARMA,All India Forward Bloc,170,0,170,0.16
53,GAUHATI EAST,8,MITALI DEKA DEVI,Lok Jan Shakti Party,252,0,252,0.23
53,GAUHATI EAST,9,DIWAS PHUKAN,Independent,717,0,717,0.66
53,GAUHATI EAST,10,PRANAY DAS,Independent,479,0,479,0.44
53,GAUHATI EAST,11,NOTA,None of the Above,1955,0,1955,1.8
54,GAUHATI WEST,1,MIRA BORTHAKUR GOSWAMI,Indian National Congress,55853,0,55853,26.3
54,GAUHATI WEST,2,RAMENDRA NARAYAN KALITA,Asom Gana Parishad,125062,0,125062,58.89
54,GAUHATI WEST,3,AVIJIT CHAKRABORTY,Bharatiya Gana Parishad,2082,0,2082,0.98
54,GAUHATI WEST,4,KALYAN KUMAR SHARMA,Republican Party of India (Athawale),1101,0,1101,0.52
54,GAUHATI WEST,5,KISHOR KUMAR DAS,Lok Jan Shakti Party,767,0,767,0.36
54,GAUHATI WEST,6,DEBAKESH MALLA BUZAR BARUAH,Janata Dal  (United),768,0,768,0.36
54,GAUHATI WEST,7,PANKAJ DAS,Swarna Bharat Party,551,0,551,0.26
54,GAUHATI WEST,8,RUNA LAILA,Assam Jatiya Parishad,5476,0,5476,2.58
54,GAUHATI WEST,9,AMITABH SARMA,Independent,840,0,840,0.4
54,GAUHATI WEST,10,KAZI NEKIB AHMED,Independent,1343,0,1343,0.63
54,GAUHATI WEST,11,DHANANJAY KALITA,Independent,5531,0,5531,2.6
54,GAUHATI WEST,12,NESARUDDIN AHMED,Independent,673,0,673,0.32
54,GAUHATI WEST,13,BALESWAR RANGPI,Independent,5806,0,5806,2.73
54,GAUHATI WEST,14,RAKTIMAVA SWAMI,Independent,1234,0,1234,0.58
54,GAUHATI WEST,15,SWAPNALI DAS,Independent,1637,0,1637,0.77
54,GAUHATI WEST,16,NOTA,None of the Above,3658,0,3658,1.72
55,HAJO,1,ANOWAR HUSSAIN(Ganesh),Indian National Congress,28456,48,28504,18.79
55,HAJO,2,SRI SUMAN HARIPRIYA,Bharatiya Janata Party,65923,242,66165,43.63
55,HAJO,3,MD INTAJOR RAHAMAN,All India Minorities Front,1335,3,1338,0.88
55,HAJO,4,Dulu Ahmed,Assam Jatiya Parishad,51710,87,51797,34.15
55,HAJO,5,MD SAFIQUL HOQUE S K,Independent,655,0,655,0.43
55,HAJO,6,JAIDEEP TALUKDAR,Independent,718,1,719,0.47
55,HAJO,7,PRABHAT KALITA,Independent,685,2,687,0.45
55,HAJO,8,MON KASHYAP,Independent,700,0,700,0.46
55,HAJO,9,NOTA,None of the Above,1099,1,1100,0.73
56,KAMALPUR,1,Kishor Kumar Bhattacharyya,Indian National Congress,62582,387,62969,41.89
56,KAMALPUR,2,Diganta Kalita,Bharatiya Janata Party,80344,739,81083,53.93
56,KAMALPUR,3,Sisir Kumar Kakati,SOCIALIST UNITY CENTRE OF INDIA (COMMUNIST),1164,7,1171,0.78
56,KAMALPUR,4,Jitul Deka,Independent,3491,17,3508,2.33
56,KAMALPUR,5,NOTA,None of the Above,1597,8,1605,1.07
57,RANGIA,1,Bhagaban Dev Misra,Communist Party of India  (Marxist),62884,0,62884,39.82
57,RANGIA,2,Bhabesh Kalita,Bharatiya Janata Party,82078,0,82078,51.98
57,RANGIA,3,Pabitra Boro,Voters Party  International,1307,0,1307,0.83
57,RANGIA,4,DR. Babul Sahariah,Assam Jatiya Parishad,3462,0,3462,2.19
57,RANGIA,5,Biswajit Brahma,Janata Dal  (United),590,0,590,0.37
57,RANGIA,6,Sahabuddin Ali Ahmed,Independent,1059,0,1059,0.67
57,RANGIA,7,Jayanta Kumar Kalita,Independent,1229,0,1229,0.78
57,RANGIA,8,Hareswar Barman,Independent,3441,0,3441,2.18
57,RANGIA,9,NOTA,None of the Above,1865,0,1865,1.18
58,TAMULPUR,1,RANGJA KHUNGUR BASUMATARY,Bodoland Peoples Front,46492,143,46635,27.66
58,TAMULPUR,2,KANAK BASUMATARY,Voters Party  International,1693,22,1715,1.02
58,TAMULPUR,3,NIRMALA DAS,Bharatiya Gana Parishad,7623,72,7695,4.56
58,TAMULPUR,4,LEHO RAM BORO,"United People’s Party, Liberal",78484,334,78818,46.75
58,TAMULPUR,5,KESHAB CHANDRA RAJBONGSHI,Independent,14344,35,14379,8.53
58,TAMULPUR,6,DIMBESWAR RABHA,Independent,1553,21,1574,0.93
58,TAMULPUR,7,NAGEN CHANDRA DAS,Independent,3696,17,3713,2.2
58,TAMULPUR,8,NILAMANI RAJBONGSHI,Independent,1357,4,1361,0.81
58,TAMULPUR,9,YASWANTA CHAUHAN,Independent,6536,13,6549,3.88
58,TAMULPUR,10,RAMCHARAN DEKA,Independent,2091,12,2103,1.25
58,TAMULPUR,11,SATYA NATH KALITA,Independent,1468,7,1475,0.87
58,TAMULPUR,12,NOTA,None of the Above,2552,10,2562,1.52
59,NALBARI,1,GOPI BARUAH,All India Trinamool Congress,1354,7,1361,0.77
59,NALBARI,2,JAYANTA MALLA BARUAH,Bharatiya Janata Party,104088,443,104531,58.87
59,NALBARI,3,PRADYUT KUMAR BHUYAN,Indian National Congress,55611,101,55712,31.37
59,NALBARI,4,KENEDI PEGU,SOCIALIST UNITY CENTRE OF INDIA (COMMUNIST),835,7,842,0.47
59,NALBARI,5,NAGEN DEKA,Assam Jatiya Parishad,11598,52,11650,6.56
59,NALBARI,6,APURBA PATHAK,Independent,564,2,566,0.32
59,NALBARI,7,KESHAB BARMAN,Independent,1128,3,1131,0.64
59,NALBARI,8,NOTA,None of the Above,1771,6,1777,1
60,BARKHETRI,1,CHAMPAK KALITA,All India United Democratic Front,911,0,911,0.7
60,BARKHETRI,2,DIGANTA BARMAN,Indian National Congress,72009,0,72009,55.47
60,BARKHETRI,3,NARAYAN DEKA,Bharatiya Janata Party,54074,0,54074,41.65
60,BARKHETRI,4,PULAKESH BARUAH,Assam Jatiya Parishad,1326,0,1326,1.02
60,BARKHETRI,5,SANTANU KALITA,Janata Dal  (United),471,0,471,0.36
60,BARKHETRI,6,BHUPEN TALUKDAR,Independent,367,0,367,0.28
60,BARKHETRI,7,NOTA,None of the Above,668,0,668,0.51
61,DHARMAPUR,1,CHANDRA MOHAN PATOWARY,Bharatiya Janata Party,55135,346,55481,56.13
61,DHARMAPUR,2,RATUL PATOWARY,Indian National Congress,35526,142,35668,36.08
61,DHARMAPUR,3,PRAMOD CHANDRA BHAGABATI,SOCIALIST UNITY CENTRE OF INDIA (COMMUNIST),453,0,453,0.46
61,DHARMAPUR,4,Dr. SHIKHAR KUMAR SARMA,Assam Jatiya Parishad,5813,25,5838,5.91
61,DHARMAPUR,5,JYOTIRMAY SHARMA,Independent,523,1,524,0.53
61,DHARMAPUR,6,NOTA,None of the Above,883,5,888,0.9
62,BARAMA,1,PRABEEN BARO,Bodoland Peoples Front,38540,73,38613,28.96
62,BARAMA,2,BHUPEN BARO,"United People’s Party, Liberal",62270,115,62385,46.78
62,BARAMA,3,SAROJANI BASUMATARY,Voters Party  International,1795,3,1798,1.35
62,BARAMA,4,NABA KUMAR SARANIA,Independent,25851,39,25890,19.42
62,BARAMA,5,PRADIP KUMAR BARO,Independent,2568,1,2569,1.93
62,BARAMA,6,NOTA,None of the Above,2090,2,2092,1.57
63,CHAPAGURI,1,HITESH BASUMATARY,Bodoland Peoples Front,34786,279,35065,27.56
63,CHAPAGURI,2,URKHAO GWRA BRAHMA,"United People’s Party, Liberal",61302,502,61804,48.58
63,CHAPAGURI,3,RAJKUMAR BARO,Voters Party  International,1415,26,1441,1.13
63,CHAPAGURI,4,KHAMPHA KHUNGUR GOYARY,Independent,907,14,921,0.72
63,CHAPAGURI,5,JYOTISH KUMAR DAS,Independent,5061,58,5119,4.02
63,CHAPAGURI,6,SUJAN DAS,Independent,20817,172,20989,16.5
63,CHAPAGURI,7,NOTA,None of the Above,1863,21,1884,1.48
64,PANERY,1,KARUNA KANTA SWARGIARY,Bodoland Peoples Front,36501,286,36787,30.8
64,PANERY,2,BISWAJIT DAIMARY,Bharatiya Janata Party,71898,741,72639,60.82
64,PANERY,3,BHUMITRA KACHARI,Voters Party  International,2080,23,2103,1.76
64,PANERY,4,SWARNALATA CHALIHA,SOCIALIST UNITY CENTRE OF INDIA (COMMUNIST),1264,16,1280,1.07
64,PANERY,5,BAPAN BANIK,Independent,1750,12,1762,1.48
64,PANERY,6,BISWAJIT MINJ,Independent,2519,14,2533,2.12
64,PANERY,7,NOTA,None of the Above,2324,11,2335,1.95
65,KALAIGAON,1,DURGA DAS BORO,Bodoland Peoples Front,45324,0,45324,37.74
65,KALAIGAON,2,MADHU RAM DEKA,Bharatiya Janata Party,45624,0,45624,37.98
65,KALAIGAON,3,KAMAL AZAD,"United People’s Party, Liberal",14428,0,14428,12.01
65,KALAIGAON,4,JITENDRA CHALIHA,SOCIALIST UNITY CENTRE OF INDIA (COMMUNIST),361,0,361,0.3
65,KALAIGAON,5,BHAGABAN DEKA,Voters Party  International,1064,0,1064,0.89
65,KALAIGAON,6,JADAV SAIKIA,Assam Jatiya Parishad,2523,0,2523,2.1
65,KALAIGAON,7,RADHE SHYAM CHAUHAN,Janata Dal  (United),443,0,443,0.37
65,KALAIGAON,8,SUDHENDU MOHAN TALUKDAR,Bharatiya Gana Parishad,612,0,612,0.51
65,KALAIGAON,9,KAMAL CHOUDHURY,Independent,1859,0,1859,1.55
65,KALAIGAON,10,KANU RAM SAIKIA,Independent,741,0,741,0.62
65,KALAIGAON,11,GWMBWR MOCHAHARY,Independent,765,0,765,0.64
65,KALAIGAON,12,DULAL KUMAR BARUAH,Independent,2146,0,2146,1.79
65,KALAIGAON,13,PANKAJ ASOMIYA,Independent,2242,0,2242,1.87
65,KALAIGAON,14,RAKESH BARO,Independent,858,0,858,0.71
65,KALAIGAON,15,NOTA,None of the Above,1121,0,1121,0.93
66,SIPAJHAR,1,KULDIP BARUA,Indian National Congress,67316,289,67605,45.52
66,SIPAJHAR,2,PARAMANANDA RAJBONGSHI,Bharatiya Janata Party,74203,536,74739,50.33
66,SIPAJHAR,3,GITIKA KAKATI,Assam Jatiya Parishad,2172,29,2201,1.48
66,SIPAJHAR,4,PAHESWARI BARUA,SOCIALIST UNITY CENTRE OF INDIA (COMMUNIST),213,6,219,0.15
66,SIPAJHAR,5,HARESWAR DEKA,Voters Party  International,420,3,423,0.28
66,SIPAJHAR,6,AMIYA KUMAR DEKA,Independent,499,8,507,0.34
66,SIPAJHAR,7,AROON BAROOA,Independent,244,4,248,0.17
66,SIPAJHAR,8,ASIFUN NESSA,Independent,357,3,360,0.24
66,SIPAJHAR,9,SAHNUR ALI,Independent,877,0,877,0.59
66,SIPAJHAR,10,NOTA,None of the Above,1323,3,1326,0.89
67,MANGALDOI,1,GURU JYOTI DAS,Bharatiya Janata Party,86294,738,87032,42.72
67,MANGALDOI,2,BASANTA DAS,Indian National Congress,111004,382,111386,54.68
67,MANGALDOI,3,GAKUL BARUAH,Assam Jatiya Parishad,2708,38,2746,1.35
67,MANGALDOI,4,JITENDRA SARKAR,Voters Party  International,977,3,980,0.48
67,MANGALDOI,5,NOTA,None of the Above,1555,12,1567,0.77
68,DALGAON,1,ILIAS ALI,Indian National Congress,62549,410,62959,29.37
68,DALGAON,2,MAZIBUR RAHMAN,All India United Democratic Front,117914,428,118342,55.2
68,DALGAON,3,HABIBAR RAHMAN,Asom Gana Parishad,28223,121,28344,13.22
68,DALGAON,4,SAIFUL HOQUE,Voters Party  International,1795,16,1811,0.84
68,DALGAON,5,ARAB ALI,Independent,1219,8,1227,0.57
68,DALGAON,6,NOTA,None of the Above,1676,13,1689,0.79
69,UDALGURI,1,Rihon Daimari,Bodoland Peoples Front,56243,673,56916,46.47
69,UDALGURI,2,GOBINDA CHANDRA BASUMATARI,"United People’s Party, Liberal",61092,675,61767,50.43
69,UDALGURI,3,NOTA,None of the Above,3774,31,3805,3.11
70,MAJBAT,1,CHARAN BORO,Bodoland Peoples Front,53903,506,54409,42.32
70,MAJBAT,2,JITU KISSAN,Bharatiya Janata Party,38006,346,38352,29.83
70,MAJBAT,3,RATENDRA DAIMARY,"United People’s Party, Liberal",28179,234,28413,22.1
70,MAJBAT,4,SUNIL SARKAR,Voters Party  International,816,11,827,0.64
70,MAJBAT,5,KHURSHID ALAM MAZUMDAR,Independent,326,7,333,0.26
70,MAJBAT,6,GOLAM MOSTAFA,Independent,565,0,565,0.44
70,MAJBAT,7,SAIFUL ISLAM,Independent,1957,14,1971,1.53
70,MAJBAT,8,JIARUL HOQUE SARKER,Independent,650,4,654,0.51
70,MAJBAT,9,SANTOSH KURMI,Independent,1240,7,1247,0.97
70,MAJBAT,10,NOTA,None of the Above,1776,9,1785,1.39
71,DHEKIAJULI,1,ASHOK SINGHAL,Bharatiya Janata Party,93329,439,93768,56.89
71,DHEKIAJULI,2,BENUDHAR NATH,Indian National Congress,58492,206,58698,35.62
71,DHEKIAJULI,3,RANJAY BASUMATARY,Voters Party  International,2058,14,2072,1.26
71,DHEKIAJULI,4,SATRUGHANA SASONI,Assam Jatiya Parishad,1547,13,1560,0.95
71,DHEKIAJULI,5,SANJOY DEY,Bharatiya Gana Parishad,1239,6,1245,0.76
71,DHEKIAJULI,6,TARUN SAHU,Independent,3480,14,3494,2.12
71,DHEKIAJULI,7,JAGYA RAM MIRDHA,Independent,1411,3,1414,0.86
71,DHEKIAJULI,8,NOTA,None of the Above,2554,5,2559,1.55
72,BARCHALLA,1,GANESH KUMAR LIMBU,Bharatiya Janata Party,70176,393,70569,51.5
72,BARCHALLA,2,RAM PRASAD SHARMA,Indian National Congress,52628,159,52787,38.52
72,BARCHALLA,3,UPEN RAJ NATH,Assam Jatiya Parishad,10108,84,10192,7.44
72,BARCHALLA,4,HEMANTA KUMAR ADHIKARY,Independent,1613,11,1624,1.19
72,BARCHALLA,5,NOTA,None of the Above,1850,6,1856,1.35
73,TEZPUR,1,ANUJ KUMAR MECH,Indian National Congress,60982,349,61331,40.93
73,TEZPUR,2,PRITHIRAJ RAVA,Asom Gana Parishad,70835,619,71454,47.69
73,TEZPUR,3,JANMONI BORAH,Assam Jatiya Parishad,8560,126,8686,5.8
73,TEZPUR,4,NAYANMONI CHOUDHURY,SOCIALIST UNITY CENTRE OF INDIA (COMMUNIST),908,8,916,0.61
73,TEZPUR,5,ALOK NATH,Independent,3973,64,4037,2.69
73,TEZPUR,6,AKASH JYOTI SINGHA,Independent,580,10,590,0.39
73,TEZPUR,7,SHEIKH MOHAMMAD SADIQUE,Independent,765,4,769,0.51
73,TEZPUR,8,NOTA,None of the Above,2007,43,2050,1.37
74,RANGAPARA,1,ABHIJIT HAZARIKA,Indian National Congress,47609,218,47827,36.26
74,RANGAPARA,2,KRISHNA KAMAL TANTI,Bharatiya Janata Party,69765,407,70172,53.2
74,RANGAPARA,3,AJAY TANTI,Assam Jatiya Parishad,2941,35,2976,2.26
74,RANGAPARA,4,ABDUL JALIL,Janata Dal  (United),558,5,563,0.43
74,RANGAPARA,5,JITENDRA KUMAR SHARMA,Voters Party  International,1048,3,1051,0.8
74,RANGAPARA,6,BIJOY TIRKEY,Independent,935,5,940,0.71
74,RANGAPARA,7,MATHEW TOPNO,Independent,6105,2,6107,4.63
74,RANGAPARA,8,NOTA,None of the Above,2268,5,2273,1.72
75,SOOTEA,1,PADMA HAZARIKA,Bharatiya Janata Party,83602,1205,84807,56.5
75,SOOTEA,2,PRANESWAR BASUMATARY,Indian National Congress,60056,376,60432,40.26
75,SOOTEA,3,ANILA BASUMATARY,Voters Party  International,2409,32,2441,1.63
75,SOOTEA,4,NOTA,None of the Above,2395,16,2411,1.61
76,BISWANATH,1,ANJAN BORAH,Indian National Congress,61687,304,61991,44.23
76,BISWANATH,2,PROMOD BORTHAKUR,Bharatiya Janata Party,70842,359,71201,50.8
76,BISWANATH,3,DULDUL BORKATAKI,Assam Jatiya Parishad,3004,29,3033,2.16
76,BISWANATH,4,DWIP BORTHAKUR,Independent,980,3,983,0.7
76,BISWANATH,5,MILICHARAN BASUMATARY,Independent,1169,2,1171,0.84
76,BISWANATH,6,NOTA,None of the Above,1766,8,1774,1.27
77,BEHALI,1,RANJIT DUTTA,Bharatiya Janata Party,53335,248,53583,50.93
77,BEHALI,2,ANJAN UPADHYAYA,Assam Jatiya Parishad,3322,21,3343,3.18
77,BEHALI,3,BIBEK DAS,Communist Party of India  (Marxist-Leninist)  (Liberation),21452,79,21531,20.46
77,BEHALI,4,JAYANTA BORAH,Independent,23617,127,23744,22.57
77,BEHALI,5,NOTA,None of the Above,3003,9,3012,2.86
78,GOHPUR,1,RIPUN BORA,Indian National Congress,63744,186,63930,39.18
78,GOHPUR,2,SRI UTPAL BORAH,Bharatiya Janata Party,92894,330,93224,57.14
78,GOHPUR,3,DR GOPAL PHUKAN,Assam Jatiya Parishad,2887,17,2904,1.78
78,GOHPUR,4,SRI SABIR NARZARY,Voters Party  International,1340,12,1352,0.83
78,GOHPUR,5,NOTA,None of the Above,1745,8,1753,1.07
79,JAGIROAD,1,PIJUSH HAZARIKA,Bharatiya Janata Party,106307,336,106643,53.54
79,JAGIROAD,2,SWAPAN KUMAR MANDAL,Indian National Congress,77055,184,77239,38.78
79,JAGIROAD,3,BUBUL DAS,Assam Jatiya Parishad,12768,47,12815,6.43
79,JAGIROAD,4,SUKANTA MAZUMDAR,Bharatiya Gana Parishad,900,3,903,0.45
79,JAGIROAD,5,NOTA,None of the Above,1593,2,1595,0.8
80,MARIGAON,1,MUNIN MAHANTA,Communist Party of India,22312,0,22312,18.09
80,MARIGAON,2,RAMA KANTA DEWRI,Bharatiya Janata Party,63141,0,63141,51.19
80,MARIGAON,3,BANI KANTA DAS,Assam Jatiya Parishad,35913,0,35913,29.12
80,MARIGAON,4,RATUL BORA,Independent,732,0,732,0.59
80,MARIGAON,5,NOTA,None of the Above,1240,0,1240,1.01
81,LAHARIGHAT,1,DR. ASIF MOHAMMAD NAZAR,Indian National Congress,60782,150,60932,37.3
81,LAHARIGHAT,2,KADIRUZZAMAN ZINNAH,Bharatiya Janata Party,34553,179,34732,21.26
81,LAHARIGHAT,3,TASLIMA NASRIN,Janata Dal  (United),420,4,424,0.26
81,LAHARIGHAT,4,SHOMZIDA YEASMIN,Assam Jatiya Parishad,1368,3,1371,0.84
81,LAHARIGHAT,5,SIDDIQUE AHMED,Independent,58739,165,58904,36.06
81,LAHARIGHAT,6,MAHANANDA PATGIRI,Independent,3774,9,3783,2.32
81,LAHARIGHAT,7,MAZAHARUL ISLAM SIDDIQUEE,Independent,846,3,849,0.52
81,LAHARIGHAT,8,RABINDRA NATH BISWAS,Independent,509,3,512,0.31
81,LAHARIGHAT,9,RAJAUL KARIM,Independent,788,1,789,0.48
81,LAHARIGHAT,10,NOTA,None of the Above,1068,5,1073,0.66
82,RAHA,1,BISHNU DAS,Asom Gana Parishad,76202,251,76453,42.75
82,RAHA,2,SASHI KANTA DAS,Indian National Congress,89356,155,89511,50.05
82,RAHA,3,UTPAL BANIA,Assam Jatiya Parishad,5542,74,5616,3.14
82,RAHA,4,MONI DAS,Janata Party,1044,66,1110,0.62
82,RAHA,5,GUNESWAR DAS,Independent,1174,40,1214,0.68
82,RAHA,6,CHITRALEKHA DAS,Independent,1124,15,1139,0.64
82,RAHA,7,RUBUL DAS,Independent,2285,4,2289,1.28
82,RAHA,8,NOTA,None of the Above,1497,20,1517,0.85
83,DHING,1,Aminul Islam,All India United Democratic Front,108269,0,108269,73.87
83,DHING,2,Sanjib Kumar Bora,Bharatiya Janata Party,8099,0,8099,5.53
83,DHING,3,Md. Anjar Hussain,Assam Jatiya Parishad,862,0,862,0.59
83,DHING,4,Inamul Huda,Revolutionary Communist Party of India  (Rasik Bhatt),2311,0,2311,1.58
83,DHING,5,Saiful Islam Choudhury,Asom Jana Morcha,616,0,616,0.42
83,DHING,6,Shahnaz Begum,Janata Dal  (United),484,0,484,0.33
83,DHING,7,Mehboob Muktar,Independent,23788,0,23788,16.23
83,DHING,8,Mustafa Shahidul Islam,Independent,899,0,899,0.61
83,DHING,9,NOTA,None of the Above,1246,0,1246,0.85
84,BATADROBA,1,Angoorlata Deka,Bharatiya Janata Party,15637,0,15637,21.33
84,BATADROBA,2,Sibamoni Bora,Indian National Congress,54726,0,54726,74.63
84,BATADROBA,3,Anupam Baruah,Janata Dal  (United),524,0,524,0.71
84,BATADROBA,4,Fakar Uddin,Asom Jana Morcha,141,0,141,0.19
84,BATADROBA,5,Musleha Begum,Rashtriya Ulama Council,220,0,220,0.3
84,BATADROBA,6,Prafulla Rajkhowa,Independent,178,0,178,0.24
84,BATADROBA,7,Matiur Rahman,Independent,1428,0,1428,1.95
84,BATADROBA,8,NOTA,None of the Above,473,0,473,0.65
85,RUPOHIHAT,1,NAJIR HUSSAIN,Bharatiya Janata Party,16306,0,16306,11.94
85,RUPOHIHAT,2,NURUL HUDA,Indian National Congress,99880,0,99880,73.11
85,RUPOHIHAT,3,SHAFIQUL ISLAM,Assam Jatiya Parishad,9119,0,9119,6.67
85,RUPOHIHAT,4,SAMSUL ALAM,Janata Dal  (United),392,0,392,0.29
85,RUPOHIHAT,5,JINNATUL ISLAM,Rashtriya Ulama Council,337,0,337,0.25
85,RUPOHIHAT,6,ABU SHAMA,Independent,967,0,967,0.71
85,RUPOHIHAT,7,WAKIBUR ISLAM,Independent,326,0,326,0.24
85,RUPOHIHAT,8,NAZRUL ISLAM,Independent,1247,0,1247,0.91
85,RUPOHIHAT,9,NURUL AMIN CHOWDHURY,Independent,7287,0,7287,5.33
85,RUPOHIHAT,10,NOTA,None of the Above,757,0,757,0.55
86,NOWGONG,1,RUPAK SARMAH,Bharatiya Janata Party,80712,386,81098,52.01
86,NOWGONG,2,SANTANU SARMA,Indian National Congress,69841,174,70015,44.9
86,NOWGONG,3,ANUP LASKAR,Assam Jatiya Parishad,1994,15,2009,1.29
86,NOWGONG,4,ABDUL AWAL BHUYAN,Lok Jan Shakti Party,172,0,172,0.11
86,NOWGONG,5,SAHJAHAN ALI AHMED,Rashtriya Ulama Council,322,0,322,0.21
86,NOWGONG,6,ANWAR WAHID,Independent,238,0,238,0.15
86,NOWGONG,7,ASHA BEGUM,Independent,352,0,352,0.23
86,NOWGONG,8,IKBAL HUSSAIN,Independent,153,0,153,0.1
86,NOWGONG,9,JIABUR RAHMAN,Independent,158,2,160,0.1
86,NOWGONG,10,NRIPENDRA MANDAL,Independent,325,3,328,0.21
86,NOWGONG,11,NOTA,None of the Above,1092,3,1095,0.7
87,BARHAMPUR,1,JITU GOSWAMI,Bharatiya Janata Party,60676,0,60676,49.36
87,BARHAMPUR,2,SURESH BORAH,Indian National Congress,58535,0,58535,47.62
87,BARHAMPUR,3,DIPIKA SAIKIA KEOT,Assam Jatiya Parishad,1663,0,1663,1.35
87,BARHAMPUR,4,PARBIN CHOUDHURY,Asom Jana Morcha,270,0,270,0.22
87,BARHAMPUR,5,SONARAM BORA,SOCIALIST UNITY CENTRE OF INDIA (COMMUNIST),429,0,429,0.35
87,BARHAMPUR,6,SAMSHEDDIN AHMED,Independent,328,0,328,0.27
87,BARHAMPUR,7,NOTA,None of the Above,1030,0,1030,0.84
88,SAMAGURI,1,ANIL SAIKIA,Bharatiya Janata Party,54790,235,55025,39.4
88,SAMAGURI,2,RAKIBUL HUSSAIN,Indian National Congress,80813,310,81123,58.09
88,SAMAGURI,3,ABIDUR RAHMAN,Assam Jatiya Parishad,1670,8,1678,1.2
88,SAMAGURI,4,PRANJIT BHOWMIK,Bharatiya Gana Parishad,702,3,705,0.5
88,SAMAGURI,5,NOTA,None of the Above,1115,1,1116,0.8
89,KALIABOR,1,Keshab Mahanta,Asom Gana Parishad,72591,1086,73677,59.06
89,KALIABOR,2,Prasanta Kumar Saikia,Indian National Congress,44243,714,44957,36.04
89,KALIABOR,3,Mukul Baruah,Assam Jatiya Parishad,2595,32,2627,2.11
89,KALIABOR,4,Bhaskar Sarmah,Independent,1624,52,1676,1.34
89,KALIABOR,5,NOTA,None of the Above,1790,19,1809,1.45
90,JAMUNAMUKH,1,Sadik Ullah Bhuyan,Asom Gana Parishad,13550,0,13550,14.65
90,JAMUNAMUKH,2,Siraj Uddin Ajmal,All India United Democratic Front,63632,0,63632,68.82
90,JAMUNAMUKH,3,Rezwan Ahmed,All India Trinamool Congress,799,0,799,0.86
90,JAMUNAMUKH,4,Jahirul Islam Laskar,Janata Dal  (United),112,0,112,0.12
90,JAMUNAMUKH,5,Bodrul Hoque,Assam Jatiya Parishad,1092,0,1092,1.18
90,JAMUNAMUKH,6,Abdul Kadir,Independent,95,0,95,0.1
90,JAMUNAMUKH,7,Abdul Malik Borbhuyan,Independent,150,0,150,0.16
90,JAMUNAMUKH,8,Gauri Kuwar,Independent,190,0,190,0.21
90,JAMUNAMUKH,9,Siraj Uddin,Independent,181,0,181,0.2
90,JAMUNAMUKH,10,Diluwara Begum Chowdhury,Independent,8991,0,8991,9.72
90,JAMUNAMUKH,11,Nashir Uddin Laskar,Independent,259,0,259,0.28
90,JAMUNAMUKH,12,Noor Ahmed,Independent,250,0,250,0.27
90,JAMUNAMUKH,13,Badar Uddin,Independent,1472,0,1472,1.59
90,JAMUNAMUKH,14,Hari Mohan Das,Independent,738,0,738,0.8
90,JAMUNAMUKH,15,NOTA,None of the Above,950,0,950,1.03
91,HOJAI,1,Debabrata Saha,Indian National Congress,41531,0,41531,60.59
91,HOJAI,2,Ramkrishna Ghosh,Bharatiya Janata Party,25794,0,25794,37.63
91,HOJAI,3,Raj Kumar Gupta,Lok Raksha Party,244,0,244,0.36
91,HOJAI,4,Dulal Sutradhar,Independent,255,0,255,0.37
91,HOJAI,5,Najmul Hussain Laskar,Independent,227,0,227,0.33
91,HOJAI,6,NOTA,None of the Above,491,0,491,0.72
92,LUMDING,1,Tutu Acharjya,All India Trinamool Congress,469,0,469,0.6
92,LUMDING,2,Sibu Misra,Bharatiya Janata Party,42109,0,42109,53.83
92,LUMDING,3,Swapan Kar,Indian National Congress,33267,0,33267,42.53
92,LUMDING,4,Mausumi Sarma Bezbaruah,Assam Jatiya Parishad,552,0,552,0.71
92,LUMDING,5,Iskikar Ahmed,Independent,257,0,257,0.33
92,LUMDING,6,Ujjal Deb,Independent,413,0,413,0.53
92,LUMDING,7,Sayed Hussain Borbhuyan,Independent,407,0,407,0.52
92,LUMDING,8,NOTA,None of the Above,753,0,753,0.96
93,BOKAKHAT,1,ATUL BORA,Asom Gana Parishad,72067,863,72930,60.56
93,BOKAKHAT,2,MRIDUL SAIKIA,Nationalist Congress Party,961,22,983,0.82
93,BOKAKHAT,3,REBA KANTA GOGOI,Assam Jatiya Parishad,2295,39,2334,1.94
93,BOKAKHAT,4,SIMON TANTI,Independent,639,10,649,0.54
93,BOKAKHAT,5,JITEN GOGOI,Independent,5453,97,5550,4.61
93,BOKAKHAT,6,JIBON CHANDRA BORAH,Independent,3281,79,3360,2.79
93,BOKAKHAT,7,DINESH KARMAKAR,Independent,912,16,928,0.77
93,BOKAKHAT,8,DULAL BORA,Independent,1521,24,1545,1.28
93,BOKAKHAT,9,PRANAB DOLEY,Independent,27405,344,27749,23.04
93,BOKAKHAT,10,BIJOY KUTUM,Independent,969,15,984,0.82
93,BOKAKHAT,11,HEMANTA DOLOI,Independent,927,6,933,0.77
93,BOKAKHAT,12,NOTA,None of the Above,2465,17,2482,2.06
94,SARUPATHAR,1,BISWAJIT PHUKAN,Bharatiya Janata Party,106425,665,107090,51.49
94,SARUPATHAR,2,ROSELINA TIRKEY,Indian National Congress,67351,380,67731,32.57
94,SARUPATHAR,3,RAJU PHUKAN,Assam Jatiya Parishad,27446,210,27656,13.3
94,SARUPATHAR,4,GOPAL GOGOI,Independent,2528,36,2564,1.23
94,SARUPATHAR,5,NOTA,None of the Above,2943,2,2945,1.42
95,GOLAGHAT,1,Ajanta Neog,Bharatiya Janata Party,81054,597,81651,50.63
95,GOLAGHAT,2,Bitupan Saikia,Indian National Congress,71841,485,72326,44.84
95,GOLAGHAT,3,Rina Saikia,Assam Jatiya Parishad,5013,49,5062,3.14
95,GOLAGHAT,4,NOTA,None of the Above,2233,12,2245,1.39
96,KHUMTAI,1,Bismita Gogoi,Indian National Congress,38284,238,38522,33.14
96,KHUMTAI,2,Mrinal Saikia,Bharatiya Janata Party,65270,385,65655,56.49
96,KHUMTAI,3,Susenfa Gogoi,Asom Songrami Mancha(Asom),1083,7,1090,0.94
96,KHUMTAI,4,Paban Saikia,Assam Jatiya Parishad,7348,20,7368,6.34
96,KHUMTAI,5,Dipak Guwala,Independent,668,4,672,0.58
96,KHUMTAI,6,Priyam Konwar,Independent,1526,1,1527,1.31
96,KHUMTAI,7,NOTA,None of the Above,1398,1,1399,1.2
97,DERGAON,1,BANI HAZARIKA,Indian National Congress,51171,375,51546,38.73
97,DERGAON,2,BHABENDRA NATH BHARALI,Asom Gana Parishad,63612,431,64043,48.12
97,DERGAON,3,ANANDA CHANDRA DAS,Assam Jatiya Parishad,7477,108,7585,5.7
97,DERGAON,4,PROBIN DAS,Independent,7452,35,7487,5.63
97,DERGAON,5,NOTA,None of the Above,2421,20,2441,1.83
98,JORHAT,1,RANA GOSWAMI,Indian National Congress,61181,652,61833,44.2
98,JORHAT,2,HITENDRA NATH GOSWAMI,Bharatiya Janata Party,67500,821,68321,48.84
98,JORHAT,3,NIROD CHANGKAKOTI,Assam Jatiya Parishad,6843,82,6925,4.95
98,JORHAT,4,RANJIT BARUAH,Independent,1087,13,1100,0.79
98,JORHAT,5,NOTA,None of the Above,1701,16,1717,1.23
99,MAJULI,1,RAJIB LOCHAN PEGU,Indian National Congress,28047,197,28244,26.7
99,MAJULI,2,SARBANANDA SONOWAL,Bharatiya Janata Party,70618,818,71436,67.53
99,MAJULI,3,BHAITY RICHONG,SOCIALIST UNITY CENTRE OF INDIA (COMMUNIST),1074,6,1080,1.02
99,MAJULI,4,SISHUDHAR DOLEY,Assam Jatiya Parishad,3201,45,3246,3.07
99,MAJULI,5,PURNA PEGU,Independent,694,7,701,0.66
99,MAJULI,6,NOTA,None of the Above,1070,5,1075,1.02
100,TITABAR,1,Bhaskar Jyoti Baruah,Indian National Congress,63711,592,64303,52.89
100,TITABAR,2,Hemanta Kalita,Bharatiya Janata Party,50425,499,50924,41.89
100,TITABAR,3,Sailendra Kumar Hazarika,Assam Jatiya Parishad,3832,53,3885,3.2
100,TITABAR,4,Dilip Gogoi,Independent,890,11,901,0.74
100,TITABAR,5,NOTA,None of the Above,1557,5,1562,1.28
101,MARIANI,1,Ramani Tanti,Bharatiya Janata Party,44703,159,44862,46.81
101,MARIANI,2,Rupjyoti Kurmi,Indian National Congress,47093,215,47308,49.36
101,MARIANI,3,Gopal Chandra Ghatuwar,Asom Songrami Mancha(Asom),1602,10,1612,1.68
101,MARIANI,4,NOTA,None of the Above,2048,8,2056,2.15
102,TEOK,1,PALLABI GOGOI,Indian National Congress,45752,453,46205,44.48
102,TEOK,2,RENUPOMA RAJKHOWA,Asom Gana Parishad,47121,434,47555,45.78
102,TEOK,3,RUBI NEOG,Lok Jan Shakti Party,1057,52,1109,1.07
102,TEOK,4,KABINDRA CHETIA PHUKAN,Independent,5923,33,5956,5.73
102,TEOK,5,SIMANTA KUMAR DUTTA,Independent,1110,10,1120,1.08
102,TEOK,6,NOTA,None of the Above,1904,23,1927,1.86
103,AMGURI,1,Angkita Dutta,Indian National Congress,43315,397,43712,42.08
103,AMGURI,2,PRODIP HAZARIKA,Asom Gana Parishad,49420,471,49891,48.03
103,AMGURI,3,Chandra Boruah,Assam Jatiya Parishad,6882,105,6987,6.73
103,AMGURI,4,Pradip Hazarika,Independent,1011,11,1022,0.98
103,AMGURI,5,Rajkumar Duwara,Independent,953,6,959,0.92
103,AMGURI,6,NOTA,None of the Above,1301,12,1313,1.26
104,NAZIRA,1,Debabrata Saikia,Indian National Congress,44715,0,44715,48.53
104,NAZIRA,2,Mayur Borgohain,Bharatiya Janata Party,42290,0,42290,45.9
104,NAZIRA,3,Ribulaya Gogoi,Assam Jatiya Parishad,2479,0,2479,2.69
104,NAZIRA,4,Horen Borgohain,All India Forward Bloc,537,0,537,0.58
104,NAZIRA,5,Mintu Boruah,Independent,906,0,906,0.98
104,NAZIRA,6,NOTA,None of the Above,1212,0,1212,1.32
105,MAHMARA,1,BIMAN BORUAH,Nationalist Congress Party,688,5,693,0.61
105,MAHMARA,2,JOGEN MOHAN,Bharatiya Janata Party,50899,383,51282,45.18
105,MAHMARA,3,SURUJ DEHINGIA,Indian National Congress,37908,239,38147,33.61
105,MAHMARA,4,BHUPEN PHUKON,All India Forward Bloc,594,1,595,0.52
105,MAHMARA,5,MANIK GOGOI,Assam Jatiya Parishad,11287,70,11357,10.01
105,MAHMARA,6,RANJIT SAHU,Independent,638,4,642,0.57
105,MAHMARA,7,LOHIT GOGOI,Independent,9405,36,9441,8.32
105,MAHMARA,8,NOTA,None of the Above,1338,2,1340,1.18
106,SONARI,1,DHARMESWAR KONWAR,Bharatiya Janata Party,69247,443,69690,48
106,SONARI,2,SUSHIL KUMAR SURI,Indian National Congress,54346,227,54573,37.59
106,SONARI,3,GAUTOM HATIMURIA,Assam Jatiya Parishad,16738,61,16799,11.57
106,SONARI,4,RATAN HEMROM,Independent,1613,4,1617,1.11
106,SONARI,5,NOTA,None of the Above,2501,9,2510,1.73
107,THOWRA,1,KUSHAL DOWARI,Bharatiya Janata Party,45613,407,46020,47.49
107,THOWRA,2,SUSHANTA BORGOHAIN,Indian National Congress,47643,383,48026,49.56
107,THOWRA,3,DIPEN TANTI,Assam Jatiya Parishad,1662,43,1705,1.76
107,THOWRA,4,NOTA,None of the Above,1140,6,1146,1.18
108,SIBSAGAR,1,Ajit Hazarika,Nationalist Congress Party,373,0,373,0.34
108,SIBSAGAR,2,Subhramitra Gogoi,Indian National Congress,16094,0,16094,14.85
108,SIBSAGAR,3,Surabhi Rajkonwari,Bharatiya Janata Party,39812,0,39812,36.74
108,SIBSAGAR,4,AKHIL GOGOI,Independent,50402,0,50402,46.52
108,SIBSAGAR,5,RUPA BORAH,Independent,718,0,718,0.66
108,SIBSAGAR,6,Hemanta Boruah,Independent,372,0,372,0.34
108,SIBSAGAR,7,NOTA,None of the Above,583,0,583,0.54
109,BIHPURIA,1,DR. AMIYA KUMAR BHUYAN,Bharatiya Janata Party,53407,0,53407,48.62
109,BIHPURIA,2,BHUPEN KUMAR BORAH,Indian National Congress,43900,0,43900,39.97
109,BIHPURIA,3,ACHYUT SAIKIA (MADHAB),Assam Jatiya Parishad,6008,0,6008,5.47
109,BIHPURIA,4,SHOBHESHWAR GOGOI,Voters Party  International,681,0,681,0.62
109,BIHPURIA,5,ANUP SAIKIA,Independent,2336,0,2336,2.13
109,BIHPURIA,6,TULESWAR PEGU,Independent,1687,0,1687,1.54
109,BIHPURIA,7,PREMADHAR BORA,Independent,659,0,659,0.6
109,BIHPURIA,8,MOHIM BANIA,Independent,412,0,412,0.38
109,BIHPURIA,9,NOTA,None of the Above,746,0,746,0.68
110,NAOBOICHA,1,JAYANTA KHAUND,Asom Gana Parishad,20023,276,20299,23.47
110,NAOBOICHA,2,DIPAK SAIKIA,Nationalist Congress Party,327,11,338,0.39
110,NAOBOICHA,3,BIRI JOY,National People's Party,2036,5,2041,2.36
110,NAOBOICHA,4,BHARAT CHANDRA NARAH,Indian National Congress,23129,208,23337,26.98
110,NAOBOICHA,5,ANUPAM CHUTIA,SOCIALIST UNITY CENTRE OF INDIA (COMMUNIST),328,1,329,0.38
110,NAOBOICHA,6,UBAIDUR RAHMAN,Rashtriya Ulama Council,290,0,290,0.34
110,NAOBOICHA,7,PUTALI KAYASTHA,Assam Jatiya Parishad,1079,28,1107,1.28
110,NAOBOICHA,8,BIKASH DEBNATH,Bharatiya Gana Parishad,1744,18,1762,2.04
110,NAOBOICHA,9,AJIJUR RAHMAN,Independent,9878,136,10014,11.58
110,NAOBOICHA,10,ABDUL GOFFUR,Independent,598,1,599,0.69
110,NAOBOICHA,11,SAHEBA AHMED,Independent,507,3,510,0.59
110,NAOBOICHA,12,RAO GAJENDRA SINGH,Independent,24566,100,24666,28.52
110,NAOBOICHA,13,NOTA,None of the Above,1189,10,1199,1.39
111,LAKHIMPUR,1,UTPAL DUTTA,Asom Gana Parishad,7310,118,7428,7.6
111,LAKHIMPUR,2,DR. JOY PRAKASH DAS (J.P.),Indian National Congress,43078,386,43464,44.46
111,LAKHIMPUR,3,MANAB DEKA,Bharatiya Janata Party,42314,355,42669,43.65
111,LAKHIMPUR,4,DILWAR HUSSAIN,Voters Party  International,520,3,523,0.53
111,LAKHIMPUR,5,BIRINCHI PEGU,SOCIALIST UNITY CENTRE OF INDIA (COMMUNIST),299,4,303,0.31
111,LAKHIMPUR,6,RANJAN BORPATRA GOHAIN,Assam Jatiya Parishad,1813,23,1836,1.88
111,LAKHIMPUR,7,NIRMAL PAYENG,Independent,745,5,750,0.77
111,LAKHIMPUR,8,NOTA,None of the Above,779,8,787,0.81
112,DHAKUAKHANA,1,NABA KUMAR DOLEY,Bharatiya Janata Party,20963,0,20963,56.69
112,DHAKUAKHANA,2,PADMALOCHAN DOLEY,Indian National Congress,13720,0,13720,37.1
112,DHAKUAKHANA,3,JUTIKA DOLEY,SOCIALIST UNITY CENTRE OF INDIA (COMMUNIST),266,0,266,0.72
112,DHAKUAKHANA,4,LALIT PEGU,Voters Party  International,512,0,512,1.38
112,DHAKUAKHANA,5,SATYAJIT REGAN,Assam Jatiya Parishad,1082,0,1082,2.93
112,DHAKUAKHANA,6,NOTA,None of the Above,438,0,438,1.18
113,DHEMAJI,1,Ranoj Pegu,Bharatiya Janata Party,33975,0,33975,49.22
113,DHEMAJI,2,Sailen Sonowal,Indian National Congress,19584,0,19584,28.37
113,DHEMAJI,3,Chittaranjan Basumatary,Assam Jatiya Parishad,13844,0,13844,20.05
113,DHEMAJI,4,Hem Kanta Miri,SOCIALIST UNITY CENTRE OF INDIA (COMMUNIST),351,0,351,0.51
113,DHEMAJI,5,Ayub Khang Brahma,Independent,661,0,661,0.96
113,DHEMAJI,6,NOTA,None of the Above,617,0,617,0.89
114,JONAI,1,BHUBAN PEGU,Bharatiya Janata Party,42334,0,42334,69.94
114,JONAI,2,HEMA HARI PRASANNA PEGU,Indian National Congress,14558,0,14558,24.05
114,JONAI,3,PHANIRAM TAYENG,Assam Jatiya Parishad,1161,0,1161,1.92
114,JONAI,4,BHAGYA CHUNGKRANG,Janata Dal  (United),301,0,301,0.5
114,JONAI,5,BHABANI BORO,Independent,346,0,346,0.57
114,JONAI,6,MADHAB MACHAHARY,Independent,1011,0,1011,1.67
114,JONAI,7,NOTA,None of the Above,820,0,820,1.35
115,MORAN,1,CHAKRADHAR GOGOI,Bharatiya Janata Party,54970,634,55604,49.68
115,MORAN,2,PRANJAL GHATOWAR,Indian National Congress,33051,212,33263,29.72
115,MORAN,3,SANJIB CHANGMAI,Assam Jatiya Parishad,9359,140,9499,8.49
115,MORAN,4,ELIASH SICHAN,Independent,507,11,518,0.46
115,MORAN,5,MOHINI MOHAN LIGIRA,Independent,8763,71,8834,7.89
115,MORAN,6,RAPHAEL KUJUR,Independent,2276,17,2293,2.05
115,MORAN,7,NOTA,None of the Above,1895,15,1910,1.71
116,DIBRUGARH,1,PRASANTA PHUKAN,Bharatiya Janata Party,68029,733,68762,60.43
116,DIBRUGARH,2,RAJKUMAR NILANETRA NEOG,Indian National Congress,30512,245,30757,27.03
116,DIBRUGARH,3,AJIT BORGOHAIN,Assam Jatiya Parishad,10971,91,11062,9.72
116,DIBRUGARH,4,SYED MAHSHINUR RAHMAN,Asom Songrami Mancha(Asom),596,5,601,0.53
116,DIBRUGARH,5,KAMAL HAZARIKA,Independent,750,5,755,0.66
116,DIBRUGARH,6,NOTA,None of the Above,1834,11,1845,1.62
117,LAHOWAL,1,BINOD HAZARIKA,Bharatiya Janata Party,58337,0,58337,48.08
117,LAHOWAL,2,MANOJ DHANOWAR,Indian National Congress,41527,0,41527,34.22
117,LAHOWAL,3,PRANAB SAIKIA,Rashtriya Lok Samta Party,1207,0,1207,0.99
117,LAHOWAL,4,LIKHON BORUAH,Assam Jatiya Parishad,10465,0,10465,8.62
117,LAHOWAL,5,DIBYAJIT  DUTTA,Independent,5525,0,5525,4.55
117,LAHOWAL,6,PROBHU LAL VAISHNAVA,Independent,1359,0,1359,1.12
117,LAHOWAL,7,NOTA,None of the Above,2923,0,2923,2.41
118,DULIAJAN,1,TERASH GOWALA,Bharatiya Janata Party,54376,386,54762,42.35
118,DULIAJAN,2,DHRUBAJYOTI GOGOI,Indian National Congress,46392,260,46652,36.08
118,DULIAJAN,3,MADHAB DAS,Lok Jan Shakti Party,1505,13,1518,1.17
118,DULIAJAN,4,LURINJYOTI GOGOI,Assam Jatiya Parishad,24027,165,24192,18.71
118,DULIAJAN,5,NOTA,None of the Above,2191,2,2193,1.7
119,TINGKHONG,1,Etuwa Munda,Indian National Congress,34162,119,34281,28.8
119,TINGKHONG,2,Bimal Borah,Bharatiya Janata Party,62118,557,62675,52.66
119,TINGKHONG,3,Subhakaran Konhain,Assam Jatiya Parishad,16618,72,16690,14.02
119,TINGKHONG,4,Bikash Kullu,Independent,3432,13,3445,2.89
119,TINGKHONG,5,NOTA,None of the Above,1921,7,1928,1.62
120,NAHARKATIA,1,TARANGA GOGOI,Bharatiya Janata Party,46999,269,47268,42.57
120,NAHARKATIA,2,NAREN SONOWAL (BOTALI),Asom Gana Parishad,4058,36,4094,3.69
120,NAHARKATIA,3,PRANATI PHUKAN,Indian National Congress,32169,123,32292,29.08
120,NAHARKATIA,4,LURINJYOTI GOGOI,Assam Jatiya Parishad,25093,139,25232,22.72
120,NAHARKATIA,5,TANU KUMAR DHADUMIA,Independent,694,2,696,0.63
120,NAHARKATIA,6,NOTA,None of the Above,1452,2,1454,1.31
121,CHABUA,1,AJOY PHUKAN,Indian National Congress,34673,151,34824,26.92
121,CHABUA,2,PONAKAN BARUAH,Asom Gana Parishad,53205,349,53554,41.4
121,CHABUA,3,ANANTA HAZARIKA,Lok Jan Shakti Party,2437,26,2463,1.9
121,CHABUA,4,PRAKASH TANTI,Rashtriya Lok Samta Party,2732,29,2761,2.13
121,CHABUA,5,PRIYANKA NEOG,Independent,16641,59,16700,12.91
121,CHABUA,6,BHABEN BARUAH,Independent,11736,57,11793,9.12
121,CHABUA,7,LAWRANCE NAG,Independent,3915,11,3926,3.04
121,CHABUA,8,NOTA,None of the Above,3325,7,3332,2.58
122,TINSUKIA,1,RABIN CHANDRA KACHARI,Nationalist Congress Party,1313,7,1320,1.01
122,TINSUKIA,2,SANJOY KISHAN,Bharatiya Janata Party,85320,537,85857,65.58
122,TINSUKIA,3,ALOK ROY,Janata Dal  (United),1175,13,1188,0.91
122,TINSUKIA,4,SHAMSHER SINGH,Assam Jatiya Parishad,14915,145,15060,11.5
122,TINSUKIA,5,CHINTU BARUAH,Lok Jan Shakti Party,757,11,768,0.59
122,TINSUKIA,6,PROBIN KUMAR HAZARIKA,Rashtriya Lok Samta Party,1066,15,1081,0.83
122,TINSUKIA,7,BUDHI NATH PRAJAPATI,Political Justice Party,2902,8,2910,2.22
122,TINSUKIA,8,SWAPAN PAUL,Bharatiya Gana Parishad,840,10,850,0.65
122,TINSUKIA,9,HIRA DEVI,Rashtriya Janata Dal,13283,38,13321,10.17
122,TINSUKIA,10,SUBHASISH BHATTACHARJEE (KAJU),Independent,5984,47,6031,4.61
122,TINSUKIA,11,NOTA,None of the Above,2513,26,2539,1.94
123,DIGBOI,1,SHIBANATH CHETIA,Indian National Congress,32063,178,32241,30.08
123,DIGBOI,2,SUREN  PHUKAN,Bharatiya Janata Party,58692,525,59217,55.24
123,DIGBOI,3,PAHLAD NAYAK,Assam Jatiya Parishad,12957,44,13001,12.13
123,DIGBOI,4,NOTA,None of the Above,2724,9,2733,2.55
124,MARGHERITA,1,BHASKAR SHARMA,Bharatiya Janata Party,47407,0,47407,51.47
124,MARGHERITA,2,MANORANJAN BORGOHAIN,Indian National Congress,17069,0,17069,18.53
124,MARGHERITA,3,SANJAY KUMAR DEB,Assam Jatiya Parishad,15977,0,15977,17.35
124,MARGHERITA,4,IGNATIUS EKKA,Independent,8117,0,8117,8.81
124,MARGHERITA,5,BHOGESWAR SHYAM,Independent,878,0,878,0.95
124,MARGHERITA,6,RANTU SONOWAL,Independent,1106,0,1106,1.2
124,MARGHERITA,7,NOTA,None of the Above,1544,0,1544,1.68
125,DOOM DOOMA,1,DURGA BHUMIJ,Indian National Congress,40791,190,40981,34.8
125,DOOM DOOMA,2,RUPESH GOWALA,Bharatiya Janata Party,48872,247,49119,41.71
125,DOOM DOOMA,3,RAJESH KISHAN,Political Justice Party,1693,10,1703,1.45
125,DOOM DOOMA,4,SURESH BHUMIJ,Assam Jatiya Parishad,4321,27,4348,3.69
125,DOOM DOOMA,5,KANAK CHETIA,Independent,2174,7,2181,1.85
125,DOOM DOOMA,6,DEBAJIT MORAN,Independent,921,8,929,0.79
125,DOOM DOOMA,7,LAKHESWAR MORAN,Independent,15224,88,15312,13
125,DOOM DOOMA,8,NOTA,None of the Above,3180,6,3186,2.71
126,SADIYA,1,BOLIN CHETIA,Bharatiya Janata Party,64147,708,64855,45.49
126,SADIYA,2,LAKHIN CHANDRA CHETIA,Indian National Congress,42217,554,42771,30
126,SADIYA,3,JAGADISH BHUYAN,Assam Jatiya Parishad,29532,317,29849,20.94
126,SADIYA,4,TIKENDRA THAPA,Voters Party  International,1086,18,1104,0.77
126,SADIYA,5,RIJUMONI GOGOI,Independent,1041,14,1055,0.74
126,SADIYA,6,LALIT DEORI,Independent,1013,10,1023,0.72
126,SADIYA,7,NOTA,None of the Above,1905,13,1918,1.35
