cid,cname,O.S.N.,Candidate,Party,EVM Votes,Postal Votes,Total Votes,PctVotes
1,MANNADIPET,1,A. KRISHNAN @ A.K. KUMAR,Dravida Munnetra Kazhagam,12016,173,12189,42.28
1,MANNADIPET,2,"K.K. MATHIVADHANAN, M.B.A., M.Phil.,",Bahujan Samaj Party,99,1,100,0.35
1,MANNADIPET,3,A. NAMASSIVAYAM,Bharatiya Janata Party,14692,247,14939,51.82
1,MANNADIPET,4,P. GOPALAKRISHNAN,Makkal Needhi Maiam,235,3,238,0.83
1,MANNADIPET,5,CHITRA,Naam Tamilar Katchi,480,5,485,1.68
1,MANNADIPET,6,C. DHANAVELU,Amma Makkal Munnettra Kazagam,56,1,57,0.2
1,MANNADIPET,7,S. MANIKANDAN,Desiya Murpokku Dravida Kazhagam,64,0,64,0.22
1,MANNADIPET,8,CHAMSOUDINE,Independent,12,0,12,0.04
1,MANNADIPET,9,SIVAKUMAR. R.M,Independent,8,0,8,0.03
1,MANNADIPET,10,SUBBURUMANI,Independent,23,2,25,0.09
1,MANNADIPET,11,BRIGHTMOON V. MURUGANANDHAM,Independent,42,1,43,0.15
1,MANNADIPET,12,VEERAPPAN,Independent,175,7,182,0.63
1,MANNADIPET,13,S. JAYABALL ALIAS SENGENI,Independent,55,0,55,0.19
1,MANNADIPET,14,NOTA,None of the Above,428,5,433,1.5
2,THIRUBHUVANAI,1,"T. UDAYAKUMAR, MLIS",Bahujan Samaj Party,77,3,80,0.28
2,THIRUBHUVANAI,2,B. KOBIGA,All India N.R. Congress,8084,154,8238,28.6
2,THIRUBHUVANAI,3,A. MUHILAN,Dravida Munnetra Kazhagam,7588,56,7644,26.53
2,THIRUBHUVANAI,4,Dr.K. SILAMBARASAN,Amma Makkal Munnettra Kazagam,229,0,229,0.79
2,THIRUBHUVANAI,5,V. SIVARAMAN,Indiya Jananayaka Katchi,115,2,117,0.41
2,THIRUBHUVANAI,6,K. RANJIT,Naam Tamilar Katchi,584,4,588,2.04
2,THIRUBHUVANAI,7,DURAI RAMESH,Makkal Needhi Maiam,481,1,482,1.67
2,THIRUBHUVANAI,8,T. VINAYAGAMOORTHY,Desiya Murpokku Dravida Kazhagam,118,1,119,0.41
2,THIRUBHUVANAI,9,P. ANGALANE,Independent,10473,124,10597,36.78
2,THIRUBHUVANAI,10,S.T. PARAMASIVAM @ CALE,Independent,180,2,182,0.63
2,THIRUBHUVANAI,11,M. SHANTHI,Independent,78,7,85,0.3
2,THIRUBHUVANAI,12,S. NADARAJAN,Independent,83,1,84,0.29
2,THIRUBHUVANAI,13,M. MANIVANNAN,Independent,79,0,79,0.27
2,THIRUBHUVANAI,14,NOTA,None of the Above,280,4,284,0.99
3,OUSSUDU,1,P. KARTHIKEYAN,Indian National Congress,12145,96,12241,42.29
3,OUSSUDU,2,AK SAI J SARAVANAN KUMAR,Bharatiya Janata Party,13903,218,14121,48.78
3,OUSSUDU,3,GEETHA PRIYA,Naam Tamilar Katchi,736,4,740,2.56
3,OUSSUDU,4,K. SANKAR,Makkal Needhi Maiam,291,2,293,1.01
3,OUSSUDU,5,R. BABOU,Desiya Murpokku Dravida Kazhagam,77,0,77,0.27
3,OUSSUDU,6,M. RAMESH,Indiya Jananayaka Katchi,14,0,14,0.05
3,OUSSUDU,7,MUTHALU VENGADESAN,Amma Makkal Munnettra Kazagam,489,7,496,1.71
3,OUSSUDU,8,ABIMANNAN,Independent,20,4,24,0.08
3,OUSSUDU,9,N. AMBIGAPATHY,Independent,314,6,320,1.11
3,OUSSUDU,10,S. SANJIV GANTHI,Independent,46,1,47,0.16
3,OUSSUDU,11,A. MURALI,Independent,164,1,165,0.57
3,OUSSUDU,12,NOTA,None of the Above,406,3,409,1.41
4,MANGALAM,1,SUN. KUMARAVEL,Dravida Munnetra Kazhagam,14047,174,14221,42.64
4,MANGALAM,2,A. Pathimaraj,Bahujan Samaj Party,104,0,104,0.31
4,MANGALAM,3,DJEACOUMAR .C,All India N.R. Congress,16600,372,16972,50.89
4,MANGALAM,4,M. Ganapathy,Amma Makkal Munnettra Kazagam,189,6,195,0.58
4,MANGALAM,5,M. SUBRAMANI,Makkal Needhi Maiam,278,1,279,0.84
4,MANGALAM,6,S. Patchaiappan,Desiya Murpokku Dravida Kazhagam,84,1,85,0.25
4,MANGALAM,7,B. BHARATHKALAI,Naam Tamilar Katchi,829,9,838,2.51
4,MANGALAM,8,Manavalan,Indiya Jananayaka Katchi,17,0,17,0.05
4,MANGALAM,9,A EGAMBARAM,Independent,37,0,37,0.11
4,MANGALAM,10,P. CANNANE,Independent,205,1,206,0.62
4,MANGALAM,11,M. Karthick,Independent,32,0,32,0.1
4,MANGALAM,12,NOTA,None of the Above,364,3,367,1.1
5,VILLIANUR,1,R. SIVA,Dravida Munnetra Kazhagam,19316,337,19653,55.73
5,VILLIANUR,2,S.V. SUGUMARAN,All India N.R. Congress,12370,333,12703,36.02
5,VILLIANUR,3,R. ARUMUGAM @ SARAVANAN,Janata Dal  (United),20,0,20,0.06
5,VILLIANUR,4,KUMARAVEL,Amma Makkal Munnettra Kazagam,160,2,162,0.46
5,VILLIANUR,5,THIAGU,Indiya Jananayaka Katchi,16,1,17,0.05
5,VILLIANUR,6,A. FAZIL,Desiya Murpokku Dravida Kazhagam,43,0,43,0.12
5,VILLIANUR,7,A. BANUMATHI,Makkal Needhi Maiam,600,9,609,1.73
5,VILLIANUR,8,PRAVEENA,Naam Tamilar Katchi,1172,10,1182,3.35
5,VILLIANUR,9,R. RAMPRASATH,Puducherry Development  Party,77,4,81,0.23
5,VILLIANUR,10,C. GUEDJENDIRANE,Independent,27,3,30,0.09
5,VILLIANUR,11,S. SHANMUGASUNDARAM,Independent,67,1,68,0.19
5,VILLIANUR,12,P. THANAMOUTTOU,Independent,73,0,73,0.21
5,VILLIANUR,13,A. MATHIVANAN,Independent,19,1,20,0.06
5,VILLIANUR,14,V. MARAN,Independent,35,0,35,0.1
5,VILLIANUR,15,N. DJEAMOURTHY,Independent,92,0,92,0.26
5,VILLIANUR,16,NOTA,None of the Above,470,8,478,1.36
6,OZHUKARAI,1,R. Sheeshapillai,Bahujan Samaj Party,87,0,87,0.27
6,OZHUKARAI,2,N.G. PANNIR SELVAM,All India N.R. Congress,10775,346,11121,34
6,OZHUKARAI,3,Angalane @ Deva Pozhilan,Viduthalai Chiruthaigal Katchi,5479,154,5633,17.22
6,OZHUKARAI,4,EJOUMALE,Amma Makkal Munnettra Kazagam,144,3,147,0.45
6,OZHUKARAI,5,S. CHITRAKALA,Janata Dal  (United),22,0,22,0.07
6,OZHUKARAI,6,V. THANGAMANI,Puducherry Development  Party,51,1,52,0.16
6,OZHUKARAI,7,S. Datchanamoorthy,Indiya Jananayaka Katchi,20,0,20,0.06
6,OZHUKARAI,8,R. Pazhanivelan,Makkal Needhi Maiam,1159,26,1185,3.62
6,OZHUKARAI,9,S. PRIYA,Naam Tamilar Katchi,1144,13,1157,3.54
6,OZHUKARAI,10,MOTHILAL .S,Communist Party of India  (Marxist-Leninist)  (Liberation),154,4,158,0.48
6,OZHUKARAI,11,Gilbert,Desiya Murpokku Dravida Kazhagam,72,7,79,0.24
6,OZHUKARAI,12,A. Santhi,Independent,99,1,100,0.31
6,OZHUKARAI,13,M. Sivasankar,Independent,11794,146,11940,36.5
6,OZHUKARAI,14,Sivasankaran,Independent,279,3,282,0.86
6,OZHUKARAI,15,A S Ramesh,Independent,95,0,95,0.29
6,OZHUKARAI,16,N. JEEVANANDAM,Independent,183,5,188,0.57
6,OZHUKARAI,17,NOTA,None of the Above,432,12,444,1.36
7,KADIRGAMAM,1,P. Selvanadane,Indian National Congress,5409,120,5529,20.47
7,KADIRGAMAM,2,K.S.P @ S. RAMESH,All India N.R. Congress,17359,416,17775,65.82
7,KADIRGAMAM,3,S. Ganesan,Amma Makkal Munnettra Kazagam,181,3,184,0.68
7,KADIRGAMAM,4,S. Sathiyavel,Indiya Jananayaka Katchi,148,2,150,0.56
7,KADIRGAMAM,5,Subasri,Naam Tamilar Katchi,2227,39,2266,8.39
7,KADIRGAMAM,6,S. Motcharajan,Desiya Murpokku Dravida Kazhagam,220,1,221,0.82
7,KADIRGAMAM,7,NOTA,None of the Above,859,21,880,3.26
8,INDIRA NAGAR,1,V. AROUMOUGAME @ AKD,All India N.R. Congress,21223,618,21841,74.77
8,INDIRA NAGAR,2,M. Kannan,Indian National Congress,3239,71,3310,11.33
8,INDIRA NAGAR,3,K. Ezhumalai,Desiya Murpokku Dravida Kazhagam,153,3,156,0.53
8,INDIRA NAGAR,4,D. Ejoumale,Indiya Jananayaka Katchi,147,5,152,0.52
8,INDIRA NAGAR,5,P. SAKTHIVEL,Makkal Needhi Maiam,1199,19,1218,4.17
8,INDIRA NAGAR,6,T. Devika,Naam Tamilar Katchi,1758,16,1774,6.07
8,INDIRA NAGAR,7,D. Mohan,Amma Makkal Munnettra Kazagam,81,2,83,0.28
8,INDIRA NAGAR,8,S. Karthigayan,Independent,109,0,109,0.37
8,INDIRA NAGAR,9,NOTA,None of the Above,560,9,569,1.95
9,THATTANCHAVADY,1,K. SETHU @ SETHU SELVAM,Communist Party of India,7355,167,7522,31.89
9,THATTANCHAVADY,2,N. Rangasamy,All India N.R. Congress,12646,332,12978,55.02
9,THATTANCHAVADY,3,R. Shanmugam,Indiya Jananayaka Katchi,41,1,42,0.18
9,THATTANCHAVADY,4,S.T. NARASSINGAM,Desiya Murpokku Dravida Kazhagam,101,2,103,0.44
9,THATTANCHAVADY,5,D. Ramesh,Naam Tamilar Katchi,1167,16,1183,5.02
9,THATTANCHAVADY,6,R. Rajendhiran,Makkal Needhi Maiam,1013,16,1029,4.36
9,THATTANCHAVADY,7,VIMALA SREE. B.,Amma Makkal Munnettra Kazagam,60,1,61,0.26
9,THATTANCHAVADY,8,C. ANUSUYA,Independent,124,4,128,0.54
9,THATTANCHAVADY,9,L. MANIKANDAN,Independent,46,2,48,0.2
9,THATTANCHAVADY,10,K. MURUGAN,Independent,52,2,54,0.23
9,THATTANCHAVADY,11,NOTA,None of the Above,417,21,438,1.86
10,KAMARAJ NAGAR,1,A. JOHNKUMAR,Bharatiya Janata Party,16303,384,16687,56.11
10,KAMARAJ NAGAR,2,M.O.H.F. SHAJAHAN,Indian National Congress,9208,250,9458,31.8
10,KAMARAJ NAGAR,3,N. NADARAJAN @ SELVA,Desiya Murpokku Dravida Kazhagam,117,2,119,0.4
10,KAMARAJ NAGAR,4,L. MUNISAMY,Amma Makkal Munnettra Kazagam,430,16,446,1.5
10,KAMARAJ NAGAR,5,N. SHARMILA BEGUM,Naam Tamilar Katchi,1955,27,1982,6.66
10,KAMARAJ NAGAR,6,ANANDARAJ,Independent,119,2,121,0.41
10,KAMARAJ NAGAR,7,SIVA. ILANGO,Independent,81,4,85,0.29
10,KAMARAJ NAGAR,8,S. SAGAYARAJ,Independent,70,0,70,0.24
10,KAMARAJ NAGAR,9,VPR. SELVAM,Independent,113,2,115,0.39
10,KAMARAJ NAGAR,10,NOTA,None of the Above,636,22,658,2.21
11,LAWSPET,1,V. SAMINATHAN,Bharatiya Janata Party,8712,179,8891,33.88
11,LAWSPET,2,M. VAITHIANATHAN,Indian National Congress,14281,311,14592,55.6
11,LAWSPET,3,N. CAMATCHY,Amma Makkal Munnettra Kazagam,70,1,71,0.27
11,LAWSPET,4,P.V. GOPI KANNAN,Indiya Jananayaka Katchi,32,1,33,0.13
11,LAWSPET,5,D. SATHIYAMOORTHY,Makkal Needhi Maiam,812,13,825,3.14
11,LAWSPET,6,NIRMAL SINGH,Naam Tamilar Katchi,1148,20,1168,4.45
11,LAWSPET,7,A. BOOPALAN,Desiya Murpokku Dravida Kazhagam,72,1,73,0.28
11,LAWSPET,8,ANNA DURAI. M,Independent,20,0,20,0.08
11,LAWSPET,9,KARUNAKARAN,Independent,20,0,20,0.08
11,LAWSPET,10,P. SENTHIL KUMAR,Independent,67,2,69,0.26
11,LAWSPET,11,C. PANDIAN,Independent,59,1,60,0.23
11,LAWSPET,12,NOTA,None of the Above,402,21,423,1.61
12,KALAPET,1,P.M.L. KALYANASUNDARAM,Bharatiya Janata Party,13052,225,13277,44.63
12,KALAPET,2,S. MOUTTOUVEL,Dravida Munnetra Kazhagam,3670,99,3769,12.67
12,KALAPET,3,P. KALIAMURTHY,Amma Makkal Munnettra Kazagam,37,2,39,0.13
12,KALAPET,4,K. KAMARAJ,Naam Tamilar Katchi,1296,25,1321,4.44
12,KALAPET,5,R. CHANDRAMOHAN,Makkal Needhi Maiam,673,12,685,2.3
12,KALAPET,6,S. HARIHARAN,Desiya Murpokku Dravida Kazhagam,156,1,157,0.53
12,KALAPET,7,C. ASOKUMAR @ RAJKUMAR,Independent,96,1,97,0.33
12,KALAPET,8,L. SUBBULAKSHMI,Independent,31,0,31,0.1
12,KALAPET,9,BALASOUBREMANIANE. A,Independent,36,0,36,0.12
12,KALAPET,10,A. SENTHIL @ RAMESH,Independent,9652,117,9769,32.84
12,KALAPET,11,E. VIGNESH,Independent,63,0,63,0.21
12,KALAPET,12,S. VENGADESSAPEROUMAL,Independent,54,0,54,0.18
12,KALAPET,13,NOTA,None of the Above,441,12,453,1.52
13,MUTHIALPET,1,R. SARAVANAN,Communist Party of India  (Marxist),312,9,321,1.37
13,MUTHIALPET,2,S. SENTHIL KUMARAN,Indian National Congress,4288,114,4402,18.79
13,MUTHIALPET,3,BALAMURUGAN,Bahujan Samaj Party,82,3,85,0.36
13,MUTHIALPET,4,VAIYAPURI MANIKANDAN,All India Anna Dravida Munnetra Kazhagam,7658,186,7844,33.49
13,MUTHIALPET,5,A. ARUNAGIRI,Desiya Murpokku Dravida Kazhagam,85,1,86,0.37
13,MUTHIALPET,6,K. SARAVANAN,Makkal Needhi Maiam,728,4,732,3.13
13,MUTHIALPET,7,M. FARITHA BEGUM,Naam Tamilar Katchi,762,16,778,3.32
13,MUTHIALPET,8,K. MURUGAN,Amma Makkal Munnettra Kazagam,51,0,51,0.22
13,MUTHIALPET,9,S. KALA,Independent,34,0,34,0.15
13,MUTHIALPET,10,J. PRAKASH KUMAR,Independent,8655,123,8778,37.48
13,MUTHIALPET,11,G. MAGESH,Independent,48,0,48,0.2
13,MUTHIALPET,12,NOTA,None of the Above,254,10,264,1.13
14,RAJ BHAVAN,1,S.P. SIVAKUMAR,Dravida Munnetra Kazhagam,6247,117,6364,32.69
14,RAJ BHAVAN,2,K. LAKSHMINARAYANAN,All India N.R. Congress,9919,177,10096,51.86
14,RAJ BHAVAN,3,ANTHONY SHARMILA,Naam Tamilar Katchi,964,11,975,5.01
14,RAJ BHAVAN,4,G. SATHISHKUMAR,Amma Makkal Munnettra Kazagam,39,0,39,0.2
14,RAJ BHAVAN,5,S. PARUVADHAVARDHNIE,Makkal Needhi Maiam,1449,13,1462,7.51
14,RAJ BHAVAN,6,M. SATHIYAN @ VIMALAN,Independent,22,0,22,0.11
14,RAJ BHAVAN,7,S.K. SUBRAMANIAN,Independent,141,3,144,0.74
14,RAJ BHAVAN,8,N. MOHAN,Independent,61,0,61,0.31
14,RAJ BHAVAN,9,NOTA,None of the Above,295,8,303,1.56
15,OUPALAM,1,A. ANBALAGAN,All India Anna Dravida Munnetra Kazhagam,8501,152,8653,36.48
15,OUPALAM,2,ANNIBAL KENNEDY,Dravida Munnetra Kazhagam,13227,206,13433,56.64
15,OUPALAM,3,JAYAKUMAR,Bahujan Samaj Party,55,1,56,0.24
15,OUPALAM,4,M. KILLIVALAVAN,Indiya Jananayaka Katchi,10,0,10,0.04
15,OUPALAM,5,V. SASIKUMAR,Desiya Murpokku Dravida Kazhagam,22,2,24,0.1
15,OUPALAM,6,SANTHOSH KUMAR,Makkal Needhi Maiam,621,8,629,2.65
15,OUPALAM,7,V. DEVIPRIYA,Naam Tamilar Katchi,559,5,564,2.38
15,OUPALAM,8,P.M.BASKAR,Amma Makkal Munnettra Kazagam,43,0,43,0.18
15,OUPALAM,9,MOHAMED SALEEM,Independent,24,1,25,0.11
15,OUPALAM,10,K. REYAZ AHAMED,Independent,22,1,23,0.1
15,OUPALAM,11,SAMIYAR @ VIJAYAKUMAR BASTE,Independent,37,1,38,0.16
15,OUPALAM,12,NOTA,None of the Above,216,3,219,0.92
16,ORLEAMPETH,1,OMSAKTHISEKAR,All India Anna Dravida Munnetra Kazhagam,1743,44,1787,8.82
16,ORLEAMPETH,2,S. GOPAL,Dravida Munnetra Kazhagam,7367,120,7487,36.96
16,ORLEAMPETH,3,R. CADIRESSAN,Desiya Murpokku Dravida Kazhagam,49,1,50,0.25
16,ORLEAMPETH,4,KARUNANITHI,Naam Tamilar Katchi,497,10,507,2.5
16,ORLEAMPETH,5,A. SIRAJ @ KANIMOHAMED,Amma Makkal Munnettra Kazagam,26,0,26,0.13
16,ORLEAMPETH,6,S. SAKTIVEL,Makkal Needhi Maiam,363,1,364,1.8
16,ORLEAMPETH,7,K. PURUSHOTHAMAN,Indiya Jananayaka Katchi,6,0,6,0.03
16,ORLEAMPETH,8,J. RAVI @ PURUSHOTHAMAN,Puratchi Bharatham,59,1,60,0.3
16,ORLEAMPETH,9,R. RAJA,Independent,14,0,14,0.07
16,ORLEAMPETH,10,G. GOPAL,Independent,4,1,5,0.02
16,ORLEAMPETH,11,P. GOPALAKRISHNAN,Independent,11,0,11,0.05
16,ORLEAMPETH,12,GOPALAKRISHNAN .M,Independent,10,0,10,0.05
16,ORLEAMPETH,13,M. SANKAR,Independent,56,0,56,0.28
16,ORLEAMPETH,14,G. NEHRU @ KUPPUSAMY,Independent,9410,170,9580,47.29
16,ORLEAMPETH,15,V. HARIHARANE,Independent,111,2,113,0.56
16,ORLEAMPETH,16,NOTA,None of the Above,177,4,181,0.89
17,NELLITHOPE,1,V. CARTIGUEYANE,Dravida Munnetra Kazhagam,11117,144,11261,40.47
17,NELLITHOPE,2,RICHARDS JOHNKUMAR,Bharatiya Janata Party,11563,194,11757,42.26
17,NELLITHOPE,3,D ARIVUMANI,My India Party,141,4,145,0.52
17,NELLITHOPE,4,R ANIFA,SOCIAL DEMOCRATIC PARTY OF INDIA,139,0,139,0.5
17,NELLITHOPE,5,R ARUMUGAM @ SARAVANAN,Janata Dal  (United),16,0,16,0.06
17,NELLITHOPE,6,S SASI KUMAR,Naam Tamilar Katchi,1506,15,1521,5.47
17,NELLITHOPE,7,R PASUPATHY,Indiya Jananayaka Katchi,18,0,18,0.06
17,NELLITHOPE,8,APR @ A. POOVARAGAVAN,Desiya Murpokku Dravida Kazhagam,99,2,101,0.36
17,NELLITHOPE,9,P MURUGESAN,Makkal Needhi Maiam,1621,38,1659,5.96
17,NELLITHOPE,10,D JENOVIA,Puducherry Development  Party,44,2,46,0.17
17,NELLITHOPE,11,ARUN @ MURUGAN,Independent,140,2,142,0.51
17,NELLITHOPE,12,E IRUDHAYARAJ,Independent,122,2,124,0.45
17,NELLITHOPE,13,"S ELUMALAI, M.A",Independent,82,1,83,0.3
17,NELLITHOPE,14,P SHIVA SANTHOSH,Independent,11,0,11,0.04
17,NELLITHOPE,15,N DELHI BABU,Independent,85,0,85,0.31
17,NELLITHOPE,16,S PRITHIVIRAJAN,Independent,177,1,178,0.64
17,NELLITHOPE,17,NOTA,None of the Above,527,10,537,1.93
18,MUDALIARPET,1,L. SAMBATH,Dravida Munnetra Kazhagam,14785,366,15151,51.3
18,MUDALIARPET,2,A. BASKAR,All India Anna Dravida Munnetra Kazhagam,10747,225,10972,37.15
18,MUDALIARPET,3,M. ARIKRISHNAN,Makkal Needhi Maiam,1293,28,1321,4.47
18,MUDALIARPET,4,M. MANIKANDAN,Amma Makkal Munnettra Kazagam,101,4,105,0.36
18,MUDALIARPET,5,M. VELAVAN,Naam Tamilar Katchi,1274,30,1304,4.41
18,MUDALIARPET,6,E. JEGANADHANE,Indiya Jananayaka Katchi,26,0,26,0.09
18,MUDALIARPET,7,K. KADIRVANAN,Independent,16,1,17,0.06
18,MUDALIARPET,8,G. SANTHOSH KUMAR,Independent,13,0,13,0.04
18,MUDALIARPET,9,E. THAMIZHARASAN,Independent,24,0,24,0.08
18,MUDALIARPET,10,S. NATARAJAN,Independent,75,3,78,0.26
18,MUDALIARPET,11,V. MANIKANDAN,Independent,18,0,18,0.06
18,MUDALIARPET,12,S. VETRIVELU,Independent,54,1,55,0.19
18,MUDALIARPET,13,NOTA,None of the Above,441,11,452,1.53
19,ARIANKUPPAM,1,R. BASKAR @ DATCHANAMOURTTY,All India N.R. Congress,17439,419,17858,54.32
19,ARIANKUPPAM,2,T. DJEAMOURTHY,Indian National Congress,11209,231,11440,34.8
19,ARIANKUPPAM,3,V INDUMATHY,Indiya Jananayaka Katchi,52,0,52,0.16
19,ARIANKUPPAM,4,SUNDARAVADIVELU,Naam Tamilar Katchi,1086,8,1094,3.33
19,ARIANKUPPAM,5,A MOHAMAD KASSIM,SOCIAL DEMOCRATIC PARTY OF INDIA,67,1,68,0.21
19,ARIANKUPPAM,6,V RUTHRAKUMARAN,Makkal Needhi Maiam,1026,29,1055,3.21
19,ARIANKUPPAM,7,LOURDUSAMY,Desiya Murpokku Dravida Kazhagam,53,2,55,0.17
19,ARIANKUPPAM,8,R KARTHICK,Independent,46,1,47,0.14
19,ARIANKUPPAM,9,S KUMARAVELU,Independent,818,5,823,2.5
19,ARIANKUPPAM,10,NOTA,None of the Above,374,8,382,1.16
20,MANAVELY,1,R. K. R. ANANTHARAMAN,Indian National Congress,8929,164,9093,30.37
20,MANAVELY,2,EMBALAM SELVAM @ R.SELVAM,Bharatiya Janata Party,16901,324,17225,57.54
20,MANAVELY,3,THAMIZHARASAN,Bahujan Samaj Party,252,8,260,0.87
20,MANAVELY,4,M S ELANGOVAN,Naam Tamilar Katchi,1539,16,1555,5.19
20,MANAVELY,5,SUNDARAMBAL @ MALARVIZHI,Makkal Needhi Maiam,412,14,426,1.42
20,MANAVELY,6,V THIRUNAVUKARASU,Desiya Murpokku Dravida Kazhagam,84,0,84,0.28
20,MANAVELY,7,J VEERASEKARAN,Indiya Jananayaka Katchi,33,2,35,0.12
20,MANAVELY,8,VEERAPUTHIRAN,Amma Makkal Munnettra Kazagam,62,0,62,0.21
20,MANAVELY,9,T ANANDAN,Independent,595,18,613,2.05
20,MANAVELY,10,DHORAPADIAR @ V.VELUSAMY,Independent,177,1,178,0.59
20,MANAVELY,11,NOTA,None of the Above,394,11,405,1.35
21,EMBALAM,1,D. ARVINDHAN,Bahujan Samaj Party,89,1,90,0.29
21,EMBALAM,2,M CANDASSAMY,Indian National Congress,13172,212,13384,43.56
21,EMBALAM,3,U LAKSHMIKANDHAN,All India N.R. Congress,15371,253,15624,50.85
21,EMBALAM,4,N SUTHA,Naam Tamilar Katchi,583,7,590,1.92
21,EMBALAM,5,N SOMANATHAN,Makkal Needhi Maiam,608,10,618,2.01
21,EMBALAM,6,P. VAITHILINGAM,Indiya Jananayaka Katchi,23,0,23,0.07
21,EMBALAM,7,S. STEEBAN,Desiya Murpokku Dravida Kazhagam,120,0,120,0.39
21,EMBALAM,8,A MURUGAIYAN,Independent,79,2,81,0.26
21,EMBALAM,9,NOTA,None of the Above,189,4,193,0.63
22,NETTAPAKKAM,1,M PARANTHAMAN,Bahujan Samaj Party,130,3,133,0.47
22,NETTAPAKKAM,2,P RAJAVELU,All India N.R. Congress,15755,223,15978,56.82
22,NETTAPAKKAM,3,V VIZEAVENY,Indian National Congress,9211,129,9340,33.21
22,NETTAPAKKAM,4,T KALYANASUNDARAM,Janata Dal  (United),81,2,83,0.3
22,NETTAPAKKAM,5,D GOVURY,Naam Tamilar Katchi,645,4,649,2.31
22,NETTAPAKKAM,6,M SELVAM,Amma Makkal Munnettra Kazagam,249,4,253,0.9
22,NETTAPAKKAM,7,B GNANAOLY,Makkal Needhi Maiam,240,1,241,0.86
22,NETTAPAKKAM,8,A VELU,Indiya Jananayaka Katchi,89,4,93,0.33
22,NETTAPAKKAM,9,C KRISHNAGOPAL,Independent,597,2,599,2.13
22,NETTAPAKKAM,10,S THIRUNAVUKKARASU,Independent,460,10,470,1.67
22,NETTAPAKKAM,11,NOTA,None of the Above,276,6,282,1
23,BAHOUR,1,R SENTHILKUMAR,Dravida Munnetra Kazhagam,11589,200,11789,44.56
23,BAHOUR,2,N DHANAVELOU,All India N.R. Congress,11311,267,11578,43.76
23,BAHOUR,3,S GNANAPRAGASH,Naam Tamilar Katchi,443,6,449,1.7
23,BAHOUR,4,A THIYAGU,Indiya Jananayaka Katchi,14,0,14,0.05
23,BAHOUR,5,C DINESH,Makkal Needhi Maiam,125,1,126,0.48
23,BAHOUR,6,S BASKARAN,Puducherry Development  Party,19,1,20,0.08
23,BAHOUR,7,P VELMURUGAN,Amma Makkal Munnettra Kazagam,1390,18,1408,5.32
23,BAHOUR,8,P VELU,Desiya Murpokku Dravida Kazhagam,79,4,83,0.31
23,BAHOUR,9,T PALANISAMY,Independent,60,1,61,0.23
23,BAHOUR,10,N PONNAMMAL,Independent,72,2,74,0.28
23,BAHOUR,11,A MURUGAN,Independent,25,1,26,0.1
23,BAHOUR,12,RAMALINGAM V,Independent,62,2,64,0.24
23,BAHOUR,13,V RUTHIRAMOORTHY,Independent,461,9,470,1.78
23,BAHOUR,14,NOTA,None of the Above,293,1,294,1.11
24,NEDUNGADU,1,A. ARULPRAKASH,Bahujan Samaj Party,84,0,84,0.31
24,NEDUNGADU,2,CHANDIRA PRIYANGA,All India N.R. Congress,10410,364,10774,40.2
24,NEDUNGADU,3,A. MARIMUTHU,Indian National Congress,8376,184,8560,31.94
24,NEDUNGADU,4,V. GEETHA,Naam Tamilar Katchi,779,9,788,2.94
24,NEDUNGADU,5,A. GNANASEGARAN,Desiya Murpokku Dravida Kazhagam,243,3,246,0.92
24,NEDUNGADU,6,T. RAJENDIRAN,Amma Makkal Munnettra Kazagam,147,6,153,0.57
24,NEDUNGADU,7,T. NARASIMHAN,Independent,81,0,81,0.3
24,NEDUNGADU,8,ANDOOR MATHI,Independent,248,4,252,0.94
24,NEDUNGADU,9,DR. V. VIGNESWARAN,Independent,5535,71,5606,20.92
24,NEDUNGADU,10,NOTA,None of the Above,251,3,254,0.95
25,THIRUNALLAR,1,R. KAMALAKKANNAN,Indian National Congress,7486,245,7731,28.77
25,THIRUNALLAR,2,S. RAJASEKARAN,Bharatiya Janata Party,8274,142,8416,31.32
25,THIRUNALLAR,3,K. GURU @ SINTHA,Desiya Murpokku Dravida Kazhagam,125,2,127,0.47
25,THIRUNALLAR,4,M. SIKKANTHAR  BATSHA,Naam Tamilar Katchi,344,3,347,1.29
25,THIRUNALLAR,5,DHARPARANIYAM,Amma Makkal Munnettra Kazagam,58,0,58,0.22
25,THIRUNALLAR,6,PR. SIVA,Independent,9551,245,9796,36.45
25,THIRUNALLAR,7,P. SIMONRAJ,Independent,66,1,67,0.25
25,THIRUNALLAR,8,M. MARIAPPANE,Independent,84,4,88,0.33
25,THIRUNALLAR,9,S. VINOTH,Independent,71,0,71,0.26
25,THIRUNALLAR,10,NOTA,None of the Above,168,5,173,0.64
26,KARAIKAL NORTH,1,A.V. SUBRAMANIAN,Indian National Congress,12215,354,12569,44.38
26,KARAIKAL NORTH,2,P.R.N. THIRUMURUGAN,All India N.R. Congress,12362,342,12704,44.85
26,KARAIKAL NORTH,3,P. ARULANANDHAM,Indiya Jananayaka Katchi,55,0,55,0.19
26,KARAIKAL NORTH,4,ANUSUYA,Naam Tamilar Katchi,1203,11,1214,4.29
26,KARAIKAL NORTH,5,K. SURESH,Makkal Needhi Maiam,354,5,359,1.27
26,KARAIKAL NORTH,6,MOHAMED THAMEEM  KANI,SOCIAL DEMOCRATIC PARTY OF INDIA,184,1,185,0.65
26,KARAIKAL NORTH,7,A. VELUSAMY,Desiya Murpokku Dravida Kazhagam,72,0,72,0.25
26,KARAIKAL NORTH,8,S. MURALI,Independent,85,1,86,0.3
26,KARAIKAL NORTH,9,B. RAJENDRAN,Independent,32,0,32,0.11
26,KARAIKAL NORTH,10,A. Vengadesh,Independent,757,9,766,2.7
26,KARAIKAL NORTH,11,NOTA,None of the Above,275,7,282,1
27,KARAIKAL SOUTH,1,K.A.U.ASSANA MARECAR,All India Anna Dravida Munnetra Kazhagam,5271,96,5367,21.95
27,KARAIKAL SOUTH,2,A.M.H. NAZIM,Dravida Munnetra Kazhagam,17042,359,17401,71.15
27,KARAIKAL SOUTH,3,A NEPOLIEAN,Indiya Jananayaka Katchi,66,1,67,0.27
27,KARAIKAL SOUTH,4,S MARIE ANTHUVAN,Naam Tamilar Katchi,697,2,699,2.86
27,KARAIKAL SOUTH,5,S MOHAMED SEEDIQUE,Amma Makkal Munnettra Kazagam,132,0,132,0.54
27,KARAIKAL SOUTH,6,R JAGATEESAN,Desiya Murpokku Dravida Kazhagam,38,1,39,0.16
27,KARAIKAL SOUTH,7,V MURUGAIA RAJENDIRAN,Independent,93,2,95,0.39
27,KARAIKAL SOUTH,8,A RAMPRASAD,Independent,433,2,435,1.78
27,KARAIKAL SOUTH,9,NOTA,None of the Above,217,4,221,0.9
28,NERAVY-T.R.PATTINAM,1,M.NAGATHIYAGARAJAN,Dravida Munnetra Kazhagam,14116,380,14496,55.74
28,NERAVY-T.R.PATTINAM,2,V.M.C.S.MANOHAREN,Bharatiya Janata Party,8788,197,8985,34.55
28,NERAVY-T.R.PATTINAM,3,A.ARULRAJU,Desiya Murpokku Dravida Kazhagam,55,0,55,0.21
28,NERAVY-T.R.PATTINAM,4,S.SELLAMUTHU,Indiya Jananayaka Katchi,35,0,35,0.13
28,NERAVY-T.R.PATTINAM,5,BALADHANDAYUDHABANI.C,Amma Makkal Munnettra Kazagam,41,4,45,0.17
28,NERAVY-T.R.PATTINAM,6,A MOHAMED YOUSUF,Naam Tamilar Katchi,468,3,471,1.81
28,NERAVY-T.R.PATTINAM,7,GEETHA ANANDAN,Independent,1474,21,1495,5.75
28,NERAVY-T.R.PATTINAM,8,V. M. C. S RAJAGANAPATHY,Independent,96,2,98,0.38
28,NERAVY-T.R.PATTINAM,9,S.SRIDHAR,Independent,139,1,140,0.54
28,NERAVY-T.R.PATTINAM,10,NOTA,None of the Above,177,9,186,0.72
29,MAHE,1,ADV. V.P. ABDUL RAHMAN,All India N.R. Congress,3476,56,3532,15.09
29,MAHE,2,RAMESH PARAMBATH,Indian National Congress,9460,284,9744,41.63
29,MAHE,3,JANAKY TEACHER,Desiya Murpokku Dravida Kazhagam,83,3,86,0.37
29,MAHE,4,C.K. UMMER MASTER,SOCIAL DEMOCRATIC PARTY OF INDIA,315,4,319,1.36
29,MAHE,5,SARATH S UNNITHAN,Independent,57,5,62,0.26
29,MAHE,6,N. HARIDASAN MASTER,Independent,9240,204,9444,40.35
29,MAHE,7,NOTA,None of the Above,215,6,221,0.94
30,YANAM,1,SUNKARA KARTHIK,Bahujan Samaj Party,89,1,90,0.26
30,YANAM,2,N.RANGASAMY,All India N.R. Congress,16228,249,16477,47.2
30,YANAM,3,PEDAPATI RAMESH BABU,Amma Makkal Munnettra Kazagam,92,0,92,0.26
30,YANAM,4,MALLADI UDAYA LAKSHMI,Independent,53,0,53,0.15
30,YANAM,5,DURGAA PRASAAHD PEMMADI,Independent,93,2,95,0.27
30,YANAM,6,GOLUGULA PRABHAVATHI,Independent,13,0,13,0.04
30,YANAM,7,NATI BURIYYA,Independent,21,0,21,0.06
30,YANAM,8,GOLLAPALLI BHARATHI,Independent,10,0,10,0.03
30,YANAM,9,SABBATI LOKESWARA RAO,Independent,12,1,13,0.04
30,YANAM,10,DAVULURY VEERA VRATHA PATHI,Independent,318,2,320,0.92
30,YANAM,11,KALLA VENKATA RATNAM,Independent,23,2,25,0.07
30,YANAM,12,TEKUMUDI VENKATA RAO,Independent,210,0,210,0.6
30,YANAM,13,GOLLAPALLI SRINIVAS ASHOK,Independent,16874,258,17132,49.07
30,YANAM,14,SURIMILLI SUBBA RAO,Independent,100,2,102,0.29
30,YANAM,15,TALATAM SURYA CHANDRA SEKHARA RAO,Independent,139,0,139,0.4
30,YANAM,16,NOTA,None of the Above,115,3,118,0.34
