cid,cname,O.S.N.,Candidate,Party,EVM Votes,Postal Votes,Total Votes,PctVotes
1,Mekliganj,1,DEBA PRASAD ROY,Indian National Congress,15203,448,15651,7.03
1,Mekliganj,2,SUMAN KANJILAL,Bharatiya Janata Party,105517,1816,107333,48.19
1,Mekliganj,3,SOURAV CHAKRABORTY (GHUTIS),All India Trinamool Congress,90183,1143,91326,41
1,Mekliganj,4,PIJUSH KANTI SARMA,SOCIALIST UNITY CENTRE OF INDIA (COMMUNIST),1090,21,1111,0.5
1,Mekliganj,5,ABINASH DAS,Independent,267,3,270,0.12
1,Mekliganj,6,ASHIM ROY,Independent,677,19,696,0.31
1,Mekliganj,7,KUSHAL KUMAR ROY,Independent,613,7,620,0.28
1,Mekliganj,8,NIKHIL CHANDRA RAIBIR,Independent,2333,18,2351,1.06
1,Mekliganj,9,RINKU GHOSH,Independent,1384,9,1393,0.63
1,Mekliganj,10,NOTA,None of the Above,1950,31,1981,0.89
2,Mathabhanga,1,DEBA PRASAD ROY,Indian National Congress,15203,448,15651,7.03
2,Mathabhanga,2,SUMAN KANJILAL,Bharatiya Janata Party,105517,1816,107333,48.19
2,Mathabhanga,3,SOURAV CHAKRABORTY (GHUTIS),All India Trinamool Congress,90183,1143,91326,41
2,Mathabhanga,4,PIJUSH KANTI SARMA,SOCIALIST UNITY CENTRE OF INDIA (COMMUNIST),1090,21,1111,0.5
2,Mathabhanga,5,ABINASH DAS,Independent,267,3,270,0.12
2,Mathabhanga,6,ASHIM ROY,Independent,677,19,696,0.31
2,Mathabhanga,7,KUSHAL KUMAR ROY,Independent,613,7,620,0.28
2,Mathabhanga,8,NIKHIL CHANDRA RAIBIR,Independent,2333,18,2351,1.06
2,Mathabhanga,9,RINKU GHOSH,Independent,1384,9,1393,0.63
2,Mathabhanga,10,NOTA,None of the Above,1950,31,1981,0.89
3,COOCHBEHAR UTTAR,1,DEBA PRASAD ROY,Indian National Congress,15203,448,15651,7.03
3,COOCHBEHAR UTTAR,2,SUMAN KANJILAL,Bharatiya Janata Party,105517,1816,107333,48.19
3,COOCHBEHAR UTTAR,3,SOURAV CHAKRABORTY (GHUTIS),All India Trinamool Congress,90183,1143,91326,41
3,COOCHBEHAR UTTAR,4,PIJUSH KANTI SARMA,SOCIALIST UNITY CENTRE OF INDIA (COMMUNIST),1090,21,1111,0.5
3,COOCHBEHAR UTTAR,5,ABINASH DAS,Independent,267,3,270,0.12
3,COOCHBEHAR UTTAR,6,ASHIM ROY,Independent,677,19,696,0.31
3,COOCHBEHAR UTTAR,7,KUSHAL KUMAR ROY,Independent,613,7,620,0.28
3,COOCHBEHAR UTTAR,8,NIKHIL CHANDRA RAIBIR,Independent,2333,18,2351,1.06
3,COOCHBEHAR UTTAR,9,RINKU GHOSH,Independent,1384,9,1393,0.63
3,COOCHBEHAR UTTAR,10,NOTA,None of the Above,1950,31,1981,0.89
4,Cooch Behar Dakshin,1,DEBA PRASAD ROY,Indian National Congress,15203,448,15651,7.03
4,Cooch Behar Dakshin,2,SUMAN KANJILAL,Bharatiya Janata Party,105517,1816,107333,48.19
4,Cooch Behar Dakshin,3,SOURAV CHAKRABORTY (GHUTIS),All India Trinamool Congress,90183,1143,91326,41
4,Cooch Behar Dakshin,4,PIJUSH KANTI SARMA,SOCIALIST UNITY CENTRE OF INDIA (COMMUNIST),1090,21,1111,0.5
4,Cooch Behar Dakshin,5,ABINASH DAS,Independent,267,3,270,0.12
4,Cooch Behar Dakshin,6,ASHIM ROY,Independent,677,19,696,0.31
4,Cooch Behar Dakshin,7,KUSHAL KUMAR ROY,Independent,613,7,620,0.28
4,Cooch Behar Dakshin,8,NIKHIL CHANDRA RAIBIR,Independent,2333,18,2351,1.06
4,Cooch Behar Dakshin,9,RINKU GHOSH,Independent,1384,9,1393,0.63
4,Cooch Behar Dakshin,10,NOTA,None of the Above,1950,31,1981,0.89
5,Sitalkuchi,1,DEBA PRASAD ROY,Indian National Congress,15203,448,15651,7.03
5,Sitalkuchi,2,SUMAN KANJILAL,Bharatiya Janata Party,105517,1816,107333,48.19
5,Sitalkuchi,3,SOURAV CHAKRABORTY (GHUTIS),All India Trinamool Congress,90183,1143,91326,41
5,Sitalkuchi,4,PIJUSH KANTI SARMA,SOCIALIST UNITY CENTRE OF INDIA (COMMUNIST),1090,21,1111,0.5
5,Sitalkuchi,5,ABINASH DAS,Independent,267,3,270,0.12
5,Sitalkuchi,6,ASHIM ROY,Independent,677,19,696,0.31
5,Sitalkuchi,7,KUSHAL KUMAR ROY,Independent,613,7,620,0.28
5,Sitalkuchi,8,NIKHIL CHANDRA RAIBIR,Independent,2333,18,2351,1.06
5,Sitalkuchi,9,RINKU GHOSH,Independent,1384,9,1393,0.63
5,Sitalkuchi,10,NOTA,None of the Above,1950,31,1981,0.89
6,Sitai,1,DEBA PRASAD ROY,Indian National Congress,15203,448,15651,7.03
6,Sitai,2,SUMAN KANJILAL,Bharatiya Janata Party,105517,1816,107333,48.19
6,Sitai,3,SOURAV CHAKRABORTY (GHUTIS),All India Trinamool Congress,90183,1143,91326,41
6,Sitai,4,PIJUSH KANTI SARMA,SOCIALIST UNITY CENTRE OF INDIA (COMMUNIST),1090,21,1111,0.5
6,Sitai,5,ABINASH DAS,Independent,267,3,270,0.12
6,Sitai,6,ASHIM ROY,Independent,677,19,696,0.31
6,Sitai,7,KUSHAL KUMAR ROY,Independent,613,7,620,0.28
6,Sitai,8,NIKHIL CHANDRA RAIBIR,Independent,2333,18,2351,1.06
6,Sitai,9,RINKU GHOSH,Independent,1384,9,1393,0.63
6,Sitai,10,NOTA,None of the Above,1950,31,1981,0.89
7,Dinhata,1,DEBA PRASAD ROY,Indian National Congress,15203,448,15651,7.03
7,Dinhata,2,SUMAN KANJILAL,Bharatiya Janata Party,105517,1816,107333,48.19
7,Dinhata,3,SOURAV CHAKRABORTY (GHUTIS),All India Trinamool Congress,90183,1143,91326,41
7,Dinhata,4,PIJUSH KANTI SARMA,SOCIALIST UNITY CENTRE OF INDIA (COMMUNIST),1090,21,1111,0.5
7,Dinhata,5,ABINASH DAS,Independent,267,3,270,0.12
7,Dinhata,6,ASHIM ROY,Independent,677,19,696,0.31
7,Dinhata,7,KUSHAL KUMAR ROY,Independent,613,7,620,0.28
7,Dinhata,8,NIKHIL CHANDRA RAIBIR,Independent,2333,18,2351,1.06
7,Dinhata,9,RINKU GHOSH,Independent,1384,9,1393,0.63
7,Dinhata,10,NOTA,None of the Above,1950,31,1981,0.89
8,Natabari,1,DEBA PRASAD ROY,Indian National Congress,15203,448,15651,7.03
8,Natabari,2,SUMAN KANJILAL,Bharatiya Janata Party,105517,1816,107333,48.19
8,Natabari,3,SOURAV CHAKRABORTY (GHUTIS),All India Trinamool Congress,90183,1143,91326,41
8,Natabari,4,PIJUSH KANTI SARMA,SOCIALIST UNITY CENTRE OF INDIA (COMMUNIST),1090,21,1111,0.5
8,Natabari,5,ABINASH DAS,Independent,267,3,270,0.12
8,Natabari,6,ASHIM ROY,Independent,677,19,696,0.31
8,Natabari,7,KUSHAL KUMAR ROY,Independent,613,7,620,0.28
8,Natabari,8,NIKHIL CHANDRA RAIBIR,Independent,2333,18,2351,1.06
8,Natabari,9,RINKU GHOSH,Independent,1384,9,1393,0.63
8,Natabari,10,NOTA,None of the Above,1950,31,1981,0.89
9,Tufanganj,1,DEBA PRASAD ROY,Indian National Congress,15203,448,15651,7.03
9,Tufanganj,2,SUMAN KANJILAL,Bharatiya Janata Party,105517,1816,107333,48.19
9,Tufanganj,3,SOURAV CHAKRABORTY (GHUTIS),All India Trinamool Congress,90183,1143,91326,41
9,Tufanganj,4,PIJUSH KANTI SARMA,SOCIALIST UNITY CENTRE OF INDIA (COMMUNIST),1090,21,1111,0.5
9,Tufanganj,5,ABINASH DAS,Independent,267,3,270,0.12
9,Tufanganj,6,ASHIM ROY,Independent,677,19,696,0.31
9,Tufanganj,7,KUSHAL KUMAR ROY,Independent,613,7,620,0.28
9,Tufanganj,8,NIKHIL CHANDRA RAIBIR,Independent,2333,18,2351,1.06
9,Tufanganj,9,RINKU GHOSH,Independent,1384,9,1393,0.63
9,Tufanganj,10,NOTA,None of the Above,1950,31,1981,0.89
10,Kumargram,1,DEBA PRASAD ROY,Indian National Congress,15203,448,15651,7.03
10,Kumargram,2,SUMAN KANJILAL,Bharatiya Janata Party,105517,1816,107333,48.19
10,Kumargram,3,SOURAV CHAKRABORTY (GHUTIS),All India Trinamool Congress,90183,1143,91326,41
10,Kumargram,4,PIJUSH KANTI SARMA,SOCIALIST UNITY CENTRE OF INDIA (COMMUNIST),1090,21,1111,0.5
10,Kumargram,5,ABINASH DAS,Independent,267,3,270,0.12
10,Kumargram,6,ASHIM ROY,Independent,677,19,696,0.31
10,Kumargram,7,KUSHAL KUMAR ROY,Independent,613,7,620,0.28
10,Kumargram,8,NIKHIL CHANDRA RAIBIR,Independent,2333,18,2351,1.06
10,Kumargram,9,RINKU GHOSH,Independent,1384,9,1393,0.63
10,Kumargram,10,NOTA,None of the Above,1950,31,1981,0.89
11,Kalchini,1,DEBA PRASAD ROY,Indian National Congress,15203,448,15651,7.03
11,Kalchini,2,SUMAN KANJILAL,Bharatiya Janata Party,105517,1816,107333,48.19
11,Kalchini,3,SOURAV CHAKRABORTY (GHUTIS),All India Trinamool Congress,90183,1143,91326,41
11,Kalchini,4,PIJUSH KANTI SARMA,SOCIALIST UNITY CENTRE OF INDIA (COMMUNIST),1090,21,1111,0.5
11,Kalchini,5,ABINASH DAS,Independent,267,3,270,0.12
11,Kalchini,6,ASHIM ROY,Independent,677,19,696,0.31
11,Kalchini,7,KUSHAL KUMAR ROY,Independent,613,7,620,0.28
11,Kalchini,8,NIKHIL CHANDRA RAIBIR,Independent,2333,18,2351,1.06
11,Kalchini,9,RINKU GHOSH,Independent,1384,9,1393,0.63
11,Kalchini,10,NOTA,None of the Above,1950,31,1981,0.89
12,Alipurduars,1,DEBA PRASAD ROY,Indian National Congress,15203,448,15651,7.03
12,Alipurduars,2,SUMAN KANJILAL,Bharatiya Janata Party,105517,1816,107333,48.19
12,Alipurduars,3,SOURAV CHAKRABORTY (GHUTIS),All India Trinamool Congress,90183,1143,91326,41
12,Alipurduars,4,PIJUSH KANTI SARMA,SOCIALIST UNITY CENTRE OF INDIA (COMMUNIST),1090,21,1111,0.5
12,Alipurduars,5,ABINASH DAS,Independent,267,3,270,0.12
12,Alipurduars,6,ASHIM ROY,Independent,677,19,696,0.31
12,Alipurduars,7,KUSHAL KUMAR ROY,Independent,613,7,620,0.28
12,Alipurduars,8,NIKHIL CHANDRA RAIBIR,Independent,2333,18,2351,1.06
12,Alipurduars,9,RINKU GHOSH,Independent,1384,9,1393,0.63
12,Alipurduars,10,NOTA,None of the Above,1950,31,1981,0.89
13,Falakata,1,DEBA PRASAD ROY,Indian National Congress,15203,448,15651,7.03
13,Falakata,2,SUMAN KANJILAL,Bharatiya Janata Party,105517,1816,107333,48.19
13,Falakata,3,SOURAV CHAKRABORTY (GHUTIS),All India Trinamool Congress,90183,1143,91326,41
13,Falakata,4,PIJUSH KANTI SARMA,SOCIALIST UNITY CENTRE OF INDIA (COMMUNIST),1090,21,1111,0.5
13,Falakata,5,ABINASH DAS,Independent,267,3,270,0.12
13,Falakata,6,ASHIM ROY,Independent,677,19,696,0.31
13,Falakata,7,KUSHAL KUMAR ROY,Independent,613,7,620,0.28
13,Falakata,8,NIKHIL CHANDRA RAIBIR,Independent,2333,18,2351,1.06
13,Falakata,9,RINKU GHOSH,Independent,1384,9,1393,0.63
13,Falakata,10,NOTA,None of the Above,1950,31,1981,0.89
14,Madarihat,1,DEBA PRASAD ROY,Indian National Congress,15203,448,15651,7.03
14,Madarihat,2,SUMAN KANJILAL,Bharatiya Janata Party,105517,1816,107333,48.19
14,Madarihat,3,SOURAV CHAKRABORTY (GHUTIS),All India Trinamool Congress,90183,1143,91326,41
14,Madarihat,4,PIJUSH KANTI SARMA,SOCIALIST UNITY CENTRE OF INDIA (COMMUNIST),1090,21,1111,0.5
14,Madarihat,5,ABINASH DAS,Independent,267,3,270,0.12
14,Madarihat,6,ASHIM ROY,Independent,677,19,696,0.31
14,Madarihat,7,KUSHAL KUMAR ROY,Independent,613,7,620,0.28
14,Madarihat,8,NIKHIL CHANDRA RAIBIR,Independent,2333,18,2351,1.06
14,Madarihat,9,RINKU GHOSH,Independent,1384,9,1393,0.63
14,Madarihat,10,NOTA,None of the Above,1950,31,1981,0.89
15,Dhupguri,1,DEBA PRASAD ROY,Indian National Congress,15203,448,15651,7.03
15,Dhupguri,2,SUMAN KANJILAL,Bharatiya Janata Party,105517,1816,107333,48.19
15,Dhupguri,3,SOURAV CHAKRABORTY (GHUTIS),All India Trinamool Congress,90183,1143,91326,41
15,Dhupguri,4,PIJUSH KANTI SARMA,SOCIALIST UNITY CENTRE OF INDIA (COMMUNIST),1090,21,1111,0.5
15,Dhupguri,5,ABINASH DAS,Independent,267,3,270,0.12
15,Dhupguri,6,ASHIM ROY,Independent,677,19,696,0.31
15,Dhupguri,7,KUSHAL KUMAR ROY,Independent,613,7,620,0.28
15,Dhupguri,8,NIKHIL CHANDRA RAIBIR,Independent,2333,18,2351,1.06
15,Dhupguri,9,RINKU GHOSH,Independent,1384,9,1393,0.63
15,Dhupguri,10,NOTA,None of the Above,1950,31,1981,0.89
16,Maynaguri,1,DEBA PRASAD ROY,Indian National Congress,15203,448,15651,7.03
16,Maynaguri,2,SUMAN KANJILAL,Bharatiya Janata Party,105517,1816,107333,48.19
16,Maynaguri,3,SOURAV CHAKRABORTY (GHUTIS),All India Trinamool Congress,90183,1143,91326,41
16,Maynaguri,4,PIJUSH KANTI SARMA,SOCIALIST UNITY CENTRE OF INDIA (COMMUNIST),1090,21,1111,0.5
16,Maynaguri,5,ABINASH DAS,Independent,267,3,270,0.12
16,Maynaguri,6,ASHIM ROY,Independent,677,19,696,0.31
16,Maynaguri,7,KUSHAL KUMAR ROY,Independent,613,7,620,0.28
16,Maynaguri,8,NIKHIL CHANDRA RAIBIR,Independent,2333,18,2351,1.06
16,Maynaguri,9,RINKU GHOSH,Independent,1384,9,1393,0.63
16,Maynaguri,10,NOTA,None of the Above,1950,31,1981,0.89
17,Jalpaiguri,1,DEBA PRASAD ROY,Indian National Congress,15203,448,15651,7.03
17,Jalpaiguri,2,SUMAN KANJILAL,Bharatiya Janata Party,105517,1816,107333,48.19
17,Jalpaiguri,3,SOURAV CHAKRABORTY (GHUTIS),All India Trinamool Congress,90183,1143,91326,41
17,Jalpaiguri,4,PIJUSH KANTI SARMA,SOCIALIST UNITY CENTRE OF INDIA (COMMUNIST),1090,21,1111,0.5
17,Jalpaiguri,5,ABINASH DAS,Independent,267,3,270,0.12
17,Jalpaiguri,6,ASHIM ROY,Independent,677,19,696,0.31
17,Jalpaiguri,7,KUSHAL KUMAR ROY,Independent,613,7,620,0.28
17,Jalpaiguri,8,NIKHIL CHANDRA RAIBIR,Independent,2333,18,2351,1.06
17,Jalpaiguri,9,RINKU GHOSH,Independent,1384,9,1393,0.63
17,Jalpaiguri,10,NOTA,None of the Above,1950,31,1981,0.89
18,Rajganj,1,DEBA PRASAD ROY,Indian National Congress,15203,448,15651,7.03
18,Rajganj,2,SUMAN KANJILAL,Bharatiya Janata Party,105517,1816,107333,48.19
18,Rajganj,3,SOURAV CHAKRABORTY (GHUTIS),All India Trinamool Congress,90183,1143,91326,41
18,Rajganj,4,PIJUSH KANTI SARMA,SOCIALIST UNITY CENTRE OF INDIA (COMMUNIST),1090,21,1111,0.5
18,Rajganj,5,ABINASH DAS,Independent,267,3,270,0.12
18,Rajganj,6,ASHIM ROY,Independent,677,19,696,0.31
18,Rajganj,7,KUSHAL KUMAR ROY,Independent,613,7,620,0.28
18,Rajganj,8,NIKHIL CHANDRA RAIBIR,Independent,2333,18,2351,1.06
18,Rajganj,9,RINKU GHOSH,Independent,1384,9,1393,0.63
18,Rajganj,10,NOTA,None of the Above,1950,31,1981,0.89
19,Dabgram-Fulbari,1,DEBA PRASAD ROY,Indian National Congress,15203,448,15651,7.03
19,Dabgram-Fulbari,2,SUMAN KANJILAL,Bharatiya Janata Party,105517,1816,107333,48.19
19,Dabgram-Fulbari,3,SOURAV CHAKRABORTY (GHUTIS),All India Trinamool Congress,90183,1143,91326,41
19,Dabgram-Fulbari,4,PIJUSH KANTI SARMA,SOCIALIST UNITY CENTRE OF INDIA (COMMUNIST),1090,21,1111,0.5
19,Dabgram-Fulbari,5,ABINASH DAS,Independent,267,3,270,0.12
19,Dabgram-Fulbari,6,ASHIM ROY,Independent,677,19,696,0.31
19,Dabgram-Fulbari,7,KUSHAL KUMAR ROY,Independent,613,7,620,0.28
19,Dabgram-Fulbari,8,NIKHIL CHANDRA RAIBIR,Independent,2333,18,2351,1.06
19,Dabgram-Fulbari,9,RINKU GHOSH,Independent,1384,9,1393,0.63
19,Dabgram-Fulbari,10,NOTA,None of the Above,1950,31,1981,0.89
20,Mal,1,DEBA PRASAD ROY,Indian National Congress,15203,448,15651,7.03
20,Mal,2,SUMAN KANJILAL,Bharatiya Janata Party,105517,1816,107333,48.19
20,Mal,3,SOURAV CHAKRABORTY (GHUTIS),All India Trinamool Congress,90183,1143,91326,41
20,Mal,4,PIJUSH KANTI SARMA,SOCIALIST UNITY CENTRE OF INDIA (COMMUNIST),1090,21,1111,0.5
20,Mal,5,ABINASH DAS,Independent,267,3,270,0.12
20,Mal,6,ASHIM ROY,Independent,677,19,696,0.31
20,Mal,7,KUSHAL KUMAR ROY,Independent,613,7,620,0.28
20,Mal,8,NIKHIL CHANDRA RAIBIR,Independent,2333,18,2351,1.06
20,Mal,9,RINKU GHOSH,Independent,1384,9,1393,0.63
20,Mal,10,NOTA,None of the Above,1950,31,1981,0.89
21,Nagrakata,1,DEBA PRASAD ROY,Indian National Congress,15203,448,15651,7.03
21,Nagrakata,2,SUMAN KANJILAL,Bharatiya Janata Party,105517,1816,107333,48.19
21,Nagrakata,3,SOURAV CHAKRABORTY (GHUTIS),All India Trinamool Congress,90183,1143,91326,41
21,Nagrakata,4,PIJUSH KANTI SARMA,SOCIALIST UNITY CENTRE OF INDIA (COMMUNIST),1090,21,1111,0.5
21,Nagrakata,5,ABINASH DAS,Independent,267,3,270,0.12
21,Nagrakata,6,ASHIM ROY,Independent,677,19,696,0.31
21,Nagrakata,7,KUSHAL KUMAR ROY,Independent,613,7,620,0.28
21,Nagrakata,8,NIKHIL CHANDRA RAIBIR,Independent,2333,18,2351,1.06
21,Nagrakata,9,RINKU GHOSH,Independent,1384,9,1393,0.63
21,Nagrakata,10,NOTA,None of the Above,1950,31,1981,0.89
22,Kalimpong,1,DEBA PRASAD ROY,Indian National Congress,15203,448,15651,7.03
22,Kalimpong,2,SUMAN KANJILAL,Bharatiya Janata Party,105517,1816,107333,48.19
22,Kalimpong,3,SOURAV CHAKRABORTY (GHUTIS),All India Trinamool Congress,90183,1143,91326,41
22,Kalimpong,4,PIJUSH KANTI SARMA,SOCIALIST UNITY CENTRE OF INDIA (COMMUNIST),1090,21,1111,0.5
22,Kalimpong,5,ABINASH DAS,Independent,267,3,270,0.12
22,Kalimpong,6,ASHIM ROY,Independent,677,19,696,0.31
22,Kalimpong,7,KUSHAL KUMAR ROY,Independent,613,7,620,0.28
22,Kalimpong,8,NIKHIL CHANDRA RAIBIR,Independent,2333,18,2351,1.06
22,Kalimpong,9,RINKU GHOSH,Independent,1384,9,1393,0.63
22,Kalimpong,10,NOTA,None of the Above,1950,31,1981,0.89
23,Darjeeling,1,DEBA PRASAD ROY,Indian National Congress,15203,448,15651,7.03
23,Darjeeling,2,SUMAN KANJILAL,Bharatiya Janata Party,105517,1816,107333,48.19
23,Darjeeling,3,SOURAV CHAKRABORTY (GHUTIS),All India Trinamool Congress,90183,1143,91326,41
23,Darjeeling,4,PIJUSH KANTI SARMA,SOCIALIST UNITY CENTRE OF INDIA (COMMUNIST),1090,21,1111,0.5
23,Darjeeling,5,ABINASH DAS,Independent,267,3,270,0.12
23,Darjeeling,6,ASHIM ROY,Independent,677,19,696,0.31
23,Darjeeling,7,KUSHAL KUMAR ROY,Independent,613,7,620,0.28
23,Darjeeling,8,NIKHIL CHANDRA RAIBIR,Independent,2333,18,2351,1.06
23,Darjeeling,9,RINKU GHOSH,Independent,1384,9,1393,0.63
23,Darjeeling,10,NOTA,None of the Above,1950,31,1981,0.89
24,Kurseong,1,DEBA PRASAD ROY,Indian National Congress,15203,448,15651,7.03
24,Kurseong,2,SUMAN KANJILAL,Bharatiya Janata Party,105517,1816,107333,48.19
24,Kurseong,3,SOURAV CHAKRABORTY (GHUTIS),All India Trinamool Congress,90183,1143,91326,41
24,Kurseong,4,PIJUSH KANTI SARMA,SOCIALIST UNITY CENTRE OF INDIA (COMMUNIST),1090,21,1111,0.5
24,Kurseong,5,ABINASH DAS,Independent,267,3,270,0.12
24,Kurseong,6,ASHIM ROY,Independent,677,19,696,0.31
24,Kurseong,7,KUSHAL KUMAR ROY,Independent,613,7,620,0.28
24,Kurseong,8,NIKHIL CHANDRA RAIBIR,Independent,2333,18,2351,1.06
24,Kurseong,9,RINKU GHOSH,Independent,1384,9,1393,0.63
24,Kurseong,10,NOTA,None of the Above,1950,31,1981,0.89
25,Matigara-Naxalbari,1,DEBA PRASAD ROY,Indian National Congress,15203,448,15651,7.03
25,Matigara-Naxalbari,2,SUMAN KANJILAL,Bharatiya Janata Party,105517,1816,107333,48.19
25,Matigara-Naxalbari,3,SOURAV CHAKRABORTY (GHUTIS),All India Trinamool Congress,90183,1143,91326,41
25,Matigara-Naxalbari,4,PIJUSH KANTI SARMA,SOCIALIST UNITY CENTRE OF INDIA (COMMUNIST),1090,21,1111,0.5
25,Matigara-Naxalbari,5,ABINASH DAS,Independent,267,3,270,0.12
25,Matigara-Naxalbari,6,ASHIM ROY,Independent,677,19,696,0.31
25,Matigara-Naxalbari,7,KUSHAL KUMAR ROY,Independent,613,7,620,0.28
25,Matigara-Naxalbari,8,NIKHIL CHANDRA RAIBIR,Independent,2333,18,2351,1.06
25,Matigara-Naxalbari,9,RINKU GHOSH,Independent,1384,9,1393,0.63
25,Matigara-Naxalbari,10,NOTA,None of the Above,1950,31,1981,0.89
26,Siliguri,1,DEBA PRASAD ROY,Indian National Congress,15203,448,15651,7.03
26,Siliguri,2,SUMAN KANJILAL,Bharatiya Janata Party,105517,1816,107333,48.19
26,Siliguri,3,SOURAV CHAKRABORTY (GHUTIS),All India Trinamool Congress,90183,1143,91326,41
26,Siliguri,4,PIJUSH KANTI SARMA,SOCIALIST UNITY CENTRE OF INDIA (COMMUNIST),1090,21,1111,0.5
26,Siliguri,5,ABINASH DAS,Independent,267,3,270,0.12
26,Siliguri,6,ASHIM ROY,Independent,677,19,696,0.31
26,Siliguri,7,KUSHAL KUMAR ROY,Independent,613,7,620,0.28
26,Siliguri,8,NIKHIL CHANDRA RAIBIR,Independent,2333,18,2351,1.06
26,Siliguri,9,RINKU GHOSH,Independent,1384,9,1393,0.63
26,Siliguri,10,NOTA,None of the Above,1950,31,1981,0.89
27,Phansidewa,1,DEBA PRASAD ROY,Indian National Congress,15203,448,15651,7.03
27,Phansidewa,2,SUMAN KANJILAL,Bharatiya Janata Party,105517,1816,107333,48.19
27,Phansidewa,3,SOURAV CHAKRABORTY (GHUTIS),All India Trinamool Congress,90183,1143,91326,41
27,Phansidewa,4,PIJUSH KANTI SARMA,SOCIALIST UNITY CENTRE OF INDIA (COMMUNIST),1090,21,1111,0.5
27,Phansidewa,5,ABINASH DAS,Independent,267,3,270,0.12
27,Phansidewa,6,ASHIM ROY,Independent,677,19,696,0.31
27,Phansidewa,7,KUSHAL KUMAR ROY,Independent,613,7,620,0.28
27,Phansidewa,8,NIKHIL CHANDRA RAIBIR,Independent,2333,18,2351,1.06
27,Phansidewa,9,RINKU GHOSH,Independent,1384,9,1393,0.63
27,Phansidewa,10,NOTA,None of the Above,1950,31,1981,0.89
28,Chopra,1,DEBA PRASAD ROY,Indian National Congress,15203,448,15651,7.03
28,Chopra,2,SUMAN KANJILAL,Bharatiya Janata Party,105517,1816,107333,48.19
28,Chopra,3,SOURAV CHAKRABORTY (GHUTIS),All India Trinamool Congress,90183,1143,91326,41
28,Chopra,4,PIJUSH KANTI SARMA,SOCIALIST UNITY CENTRE OF INDIA (COMMUNIST),1090,21,1111,0.5
28,Chopra,5,ABINASH DAS,Independent,267,3,270,0.12
28,Chopra,6,ASHIM ROY,Independent,677,19,696,0.31
28,Chopra,7,KUSHAL KUMAR ROY,Independent,613,7,620,0.28
28,Chopra,8,NIKHIL CHANDRA RAIBIR,Independent,2333,18,2351,1.06
28,Chopra,9,RINKU GHOSH,Independent,1384,9,1393,0.63
28,Chopra,10,NOTA,None of the Above,1950,31,1981,0.89
29,Islampur,1,DEBA PRASAD ROY,Indian National Congress,15203,448,15651,7.03
29,Islampur,2,SUMAN KANJILAL,Bharatiya Janata Party,105517,1816,107333,48.19
29,Islampur,3,SOURAV CHAKRABORTY (GHUTIS),All India Trinamool Congress,90183,1143,91326,41
29,Islampur,4,PIJUSH KANTI SARMA,SOCIALIST UNITY CENTRE OF INDIA (COMMUNIST),1090,21,1111,0.5
29,Islampur,5,ABINASH DAS,Independent,267,3,270,0.12
29,Islampur,6,ASHIM ROY,Independent,677,19,696,0.31
29,Islampur,7,KUSHAL KUMAR ROY,Independent,613,7,620,0.28
29,Islampur,8,NIKHIL CHANDRA RAIBIR,Independent,2333,18,2351,1.06
29,Islampur,9,RINKU GHOSH,Independent,1384,9,1393,0.63
29,Islampur,10,NOTA,None of the Above,1950,31,1981,0.89
30,Goalpokhar,1,DEBA PRASAD ROY,Indian National Congress,15203,448,15651,7.03
30,Goalpokhar,2,SUMAN KANJILAL,Bharatiya Janata Party,105517,1816,107333,48.19
30,Goalpokhar,3,SOURAV CHAKRABORTY (GHUTIS),All India Trinamool Congress,90183,1143,91326,41
30,Goalpokhar,4,PIJUSH KANTI SARMA,SOCIALIST UNITY CENTRE OF INDIA (COMMUNIST),1090,21,1111,0.5
30,Goalpokhar,5,ABINASH DAS,Independent,267,3,270,0.12
30,Goalpokhar,6,ASHIM ROY,Independent,677,19,696,0.31
30,Goalpokhar,7,KUSHAL KUMAR ROY,Independent,613,7,620,0.28
30,Goalpokhar,8,NIKHIL CHANDRA RAIBIR,Independent,2333,18,2351,1.06
30,Goalpokhar,9,RINKU GHOSH,Independent,1384,9,1393,0.63
30,Goalpokhar,10,NOTA,None of the Above,1950,31,1981,0.89
31,Chakulia,1,DEBA PRASAD ROY,Indian National Congress,15203,448,15651,7.03
31,Chakulia,2,SUMAN KANJILAL,Bharatiya Janata Party,105517,1816,107333,48.19
31,Chakulia,3,SOURAV CHAKRABORTY (GHUTIS),All India Trinamool Congress,90183,1143,91326,41
31,Chakulia,4,PIJUSH KANTI SARMA,SOCIALIST UNITY CENTRE OF INDIA (COMMUNIST),1090,21,1111,0.5
31,Chakulia,5,ABINASH DAS,Independent,267,3,270,0.12
31,Chakulia,6,ASHIM ROY,Independent,677,19,696,0.31
31,Chakulia,7,KUSHAL KUMAR ROY,Independent,613,7,620,0.28
31,Chakulia,8,NIKHIL CHANDRA RAIBIR,Independent,2333,18,2351,1.06
31,Chakulia,9,RINKU GHOSH,Independent,1384,9,1393,0.63
31,Chakulia,10,NOTA,None of the Above,1950,31,1981,0.89
32,Karandighi,1,DEBA PRASAD ROY,Indian National Congress,15203,448,15651,7.03
32,Karandighi,2,SUMAN KANJILAL,Bharatiya Janata Party,105517,1816,107333,48.19
32,Karandighi,3,SOURAV CHAKRABORTY (GHUTIS),All India Trinamool Congress,90183,1143,91326,41
32,Karandighi,4,PIJUSH KANTI SARMA,SOCIALIST UNITY CENTRE OF INDIA (COMMUNIST),1090,21,1111,0.5
32,Karandighi,5,ABINASH DAS,Independent,267,3,270,0.12
32,Karandighi,6,ASHIM ROY,Independent,677,19,696,0.31
32,Karandighi,7,KUSHAL KUMAR ROY,Independent,613,7,620,0.28
32,Karandighi,8,NIKHIL CHANDRA RAIBIR,Independent,2333,18,2351,1.06
32,Karandighi,9,RINKU GHOSH,Independent,1384,9,1393,0.63
32,Karandighi,10,NOTA,None of the Above,1950,31,1981,0.89
33,Hemtabad,1,DEBA PRASAD ROY,Indian National Congress,15203,448,15651,7.03
33,Hemtabad,2,SUMAN KANJILAL,Bharatiya Janata Party,105517,1816,107333,48.19
33,Hemtabad,3,SOURAV CHAKRABORTY (GHUTIS),All India Trinamool Congress,90183,1143,91326,41
33,Hemtabad,4,PIJUSH KANTI SARMA,SOCIALIST UNITY CENTRE OF INDIA (COMMUNIST),1090,21,1111,0.5
33,Hemtabad,5,ABINASH DAS,Independent,267,3,270,0.12
33,Hemtabad,6,ASHIM ROY,Independent,677,19,696,0.31
33,Hemtabad,7,KUSHAL KUMAR ROY,Independent,613,7,620,0.28
33,Hemtabad,8,NIKHIL CHANDRA RAIBIR,Independent,2333,18,2351,1.06
33,Hemtabad,9,RINKU GHOSH,Independent,1384,9,1393,0.63
33,Hemtabad,10,NOTA,None of the Above,1950,31,1981,0.89
34,Kaliaganj,1,DEBA PRASAD ROY,Indian National Congress,15203,448,15651,7.03
34,Kaliaganj,2,SUMAN KANJILAL,Bharatiya Janata Party,105517,1816,107333,48.19
34,Kaliaganj,3,SOURAV CHAKRABORTY (GHUTIS),All India Trinamool Congress,90183,1143,91326,41
34,Kaliaganj,4,PIJUSH KANTI SARMA,SOCIALIST UNITY CENTRE OF INDIA (COMMUNIST),1090,21,1111,0.5
34,Kaliaganj,5,ABINASH DAS,Independent,267,3,270,0.12
34,Kaliaganj,6,ASHIM ROY,Independent,677,19,696,0.31
34,Kaliaganj,7,KUSHAL KUMAR ROY,Independent,613,7,620,0.28
34,Kaliaganj,8,NIKHIL CHANDRA RAIBIR,Independent,2333,18,2351,1.06
34,Kaliaganj,9,RINKU GHOSH,Independent,1384,9,1393,0.63
34,Kaliaganj,10,NOTA,None of the Above,1950,31,1981,0.89
35,Raiganj,1,DEBA PRASAD ROY,Indian National Congress,15203,448,15651,7.03
35,Raiganj,2,SUMAN KANJILAL,Bharatiya Janata Party,105517,1816,107333,48.19
35,Raiganj,3,SOURAV CHAKRABORTY (GHUTIS),All India Trinamool Congress,90183,1143,91326,41
35,Raiganj,4,PIJUSH KANTI SARMA,SOCIALIST UNITY CENTRE OF INDIA (COMMUNIST),1090,21,1111,0.5
35,Raiganj,5,ABINASH DAS,Independent,267,3,270,0.12
35,Raiganj,6,ASHIM ROY,Independent,677,19,696,0.31
35,Raiganj,7,KUSHAL KUMAR ROY,Independent,613,7,620,0.28
35,Raiganj,8,NIKHIL CHANDRA RAIBIR,Independent,2333,18,2351,1.06
35,Raiganj,9,RINKU GHOSH,Independent,1384,9,1393,0.63
35,Raiganj,10,NOTA,None of the Above,1950,31,1981,0.89
36,Itahar,1,DEBA PRASAD ROY,Indian National Congress,15203,448,15651,7.03
36,Itahar,2,SUMAN KANJILAL,Bharatiya Janata Party,105517,1816,107333,48.19
36,Itahar,3,SOURAV CHAKRABORTY (GHUTIS),All India Trinamool Congress,90183,1143,91326,41
36,Itahar,4,PIJUSH KANTI SARMA,SOCIALIST UNITY CENTRE OF INDIA (COMMUNIST),1090,21,1111,0.5
36,Itahar,5,ABINASH DAS,Independent,267,3,270,0.12
36,Itahar,6,ASHIM ROY,Independent,677,19,696,0.31
36,Itahar,7,KUSHAL KUMAR ROY,Independent,613,7,620,0.28
36,Itahar,8,NIKHIL CHANDRA RAIBIR,Independent,2333,18,2351,1.06
36,Itahar,9,RINKU GHOSH,Independent,1384,9,1393,0.63
36,Itahar,10,NOTA,None of the Above,1950,31,1981,0.89
37,Kushmandi,1,DEBA PRASAD ROY,Indian National Congress,15203,448,15651,7.03
37,Kushmandi,2,SUMAN KANJILAL,Bharatiya Janata Party,105517,1816,107333,48.19
37,Kushmandi,3,SOURAV CHAKRABORTY (GHUTIS),All India Trinamool Congress,90183,1143,91326,41
37,Kushmandi,4,PIJUSH KANTI SARMA,SOCIALIST UNITY CENTRE OF INDIA (COMMUNIST),1090,21,1111,0.5
37,Kushmandi,5,ABINASH DAS,Independent,267,3,270,0.12
37,Kushmandi,6,ASHIM ROY,Independent,677,19,696,0.31
37,Kushmandi,7,KUSHAL KUMAR ROY,Independent,613,7,620,0.28
37,Kushmandi,8,NIKHIL CHANDRA RAIBIR,Independent,2333,18,2351,1.06
37,Kushmandi,9,RINKU GHOSH,Independent,1384,9,1393,0.63
37,Kushmandi,10,NOTA,None of the Above,1950,31,1981,0.89
38,Kumarganj,1,DEBA PRASAD ROY,Indian National Congress,15203,448,15651,7.03
38,Kumarganj,2,SUMAN KANJILAL,Bharatiya Janata Party,105517,1816,107333,48.19
38,Kumarganj,3,SOURAV CHAKRABORTY (GHUTIS),All India Trinamool Congress,90183,1143,91326,41
38,Kumarganj,4,PIJUSH KANTI SARMA,SOCIALIST UNITY CENTRE OF INDIA (COMMUNIST),1090,21,1111,0.5
38,Kumarganj,5,ABINASH DAS,Independent,267,3,270,0.12
38,Kumarganj,6,ASHIM ROY,Independent,677,19,696,0.31
38,Kumarganj,7,KUSHAL KUMAR ROY,Independent,613,7,620,0.28
38,Kumarganj,8,NIKHIL CHANDRA RAIBIR,Independent,2333,18,2351,1.06
38,Kumarganj,9,RINKU GHOSH,Independent,1384,9,1393,0.63
38,Kumarganj,10,NOTA,None of the Above,1950,31,1981,0.89
39,Balurghat,1,DEBA PRASAD ROY,Indian National Congress,15203,448,15651,7.03
39,Balurghat,2,SUMAN KANJILAL,Bharatiya Janata Party,105517,1816,107333,48.19
39,Balurghat,3,SOURAV CHAKRABORTY (GHUTIS),All India Trinamool Congress,90183,1143,91326,41
39,Balurghat,4,PIJUSH KANTI SARMA,SOCIALIST UNITY CENTRE OF INDIA (COMMUNIST),1090,21,1111,0.5
39,Balurghat,5,ABINASH DAS,Independent,267,3,270,0.12
39,Balurghat,6,ASHIM ROY,Independent,677,19,696,0.31
39,Balurghat,7,KUSHAL KUMAR ROY,Independent,613,7,620,0.28
39,Balurghat,8,NIKHIL CHANDRA RAIBIR,Independent,2333,18,2351,1.06
39,Balurghat,9,RINKU GHOSH,Independent,1384,9,1393,0.63
39,Balurghat,10,NOTA,None of the Above,1950,31,1981,0.89
40,Tapan,1,DEBA PRASAD ROY,Indian National Congress,15203,448,15651,7.03
40,Tapan,2,SUMAN KANJILAL,Bharatiya Janata Party,105517,1816,107333,48.19
40,Tapan,3,SOURAV CHAKRABORTY (GHUTIS),All India Trinamool Congress,90183,1143,91326,41
40,Tapan,4,PIJUSH KANTI SARMA,SOCIALIST UNITY CENTRE OF INDIA (COMMUNIST),1090,21,1111,0.5
40,Tapan,5,ABINASH DAS,Independent,267,3,270,0.12
40,Tapan,6,ASHIM ROY,Independent,677,19,696,0.31
40,Tapan,7,KUSHAL KUMAR ROY,Independent,613,7,620,0.28
40,Tapan,8,NIKHIL CHANDRA RAIBIR,Independent,2333,18,2351,1.06
40,Tapan,9,RINKU GHOSH,Independent,1384,9,1393,0.63
40,Tapan,10,NOTA,None of the Above,1950,31,1981,0.89
41,Gangarampur,1,DEBA PRASAD ROY,Indian National Congress,15203,448,15651,7.03
41,Gangarampur,2,SUMAN KANJILAL,Bharatiya Janata Party,105517,1816,107333,48.19
41,Gangarampur,3,SOURAV CHAKRABORTY (GHUTIS),All India Trinamool Congress,90183,1143,91326,41
41,Gangarampur,4,PIJUSH KANTI SARMA,SOCIALIST UNITY CENTRE OF INDIA (COMMUNIST),1090,21,1111,0.5
41,Gangarampur,5,ABINASH DAS,Independent,267,3,270,0.12
41,Gangarampur,6,ASHIM ROY,Independent,677,19,696,0.31
41,Gangarampur,7,KUSHAL KUMAR ROY,Independent,613,7,620,0.28
41,Gangarampur,8,NIKHIL CHANDRA RAIBIR,Independent,2333,18,2351,1.06
41,Gangarampur,9,RINKU GHOSH,Independent,1384,9,1393,0.63
41,Gangarampur,10,NOTA,None of the Above,1950,31,1981,0.89
42,Harirampur,1,DEBA PRASAD ROY,Indian National Congress,15203,448,15651,7.03
42,Harirampur,2,SUMAN KANJILAL,Bharatiya Janata Party,105517,1816,107333,48.19
42,Harirampur,3,SOURAV CHAKRABORTY (GHUTIS),All India Trinamool Congress,90183,1143,91326,41
42,Harirampur,4,PIJUSH KANTI SARMA,SOCIALIST UNITY CENTRE OF INDIA (COMMUNIST),1090,21,1111,0.5
42,Harirampur,5,ABINASH DAS,Independent,267,3,270,0.12
42,Harirampur,6,ASHIM ROY,Independent,677,19,696,0.31
42,Harirampur,7,KUSHAL KUMAR ROY,Independent,613,7,620,0.28
42,Harirampur,8,NIKHIL CHANDRA RAIBIR,Independent,2333,18,2351,1.06
42,Harirampur,9,RINKU GHOSH,Independent,1384,9,1393,0.63
42,Harirampur,10,NOTA,None of the Above,1950,31,1981,0.89
43,Habibpur,1,DEBA PRASAD ROY,Indian National Congress,15203,448,15651,7.03
43,Habibpur,2,SUMAN KANJILAL,Bharatiya Janata Party,105517,1816,107333,48.19
43,Habibpur,3,SOURAV CHAKRABORTY (GHUTIS),All India Trinamool Congress,90183,1143,91326,41
43,Habibpur,4,PIJUSH KANTI SARMA,SOCIALIST UNITY CENTRE OF INDIA (COMMUNIST),1090,21,1111,0.5
43,Habibpur,5,ABINASH DAS,Independent,267,3,270,0.12
43,Habibpur,6,ASHIM ROY,Independent,677,19,696,0.31
43,Habibpur,7,KUSHAL KUMAR ROY,Independent,613,7,620,0.28
43,Habibpur,8,NIKHIL CHANDRA RAIBIR,Independent,2333,18,2351,1.06
43,Habibpur,9,RINKU GHOSH,Independent,1384,9,1393,0.63
43,Habibpur,10,NOTA,None of the Above,1950,31,1981,0.89
44,Gazole,1,DEBA PRASAD ROY,Indian National Congress,15203,448,15651,7.03
44,Gazole,2,SUMAN KANJILAL,Bharatiya Janata Party,105517,1816,107333,48.19
44,Gazole,3,SOURAV CHAKRABORTY (GHUTIS),All India Trinamool Congress,90183,1143,91326,41
44,Gazole,4,PIJUSH KANTI SARMA,SOCIALIST UNITY CENTRE OF INDIA (COMMUNIST),1090,21,1111,0.5
44,Gazole,5,ABINASH DAS,Independent,267,3,270,0.12
44,Gazole,6,ASHIM ROY,Independent,677,19,696,0.31
44,Gazole,7,KUSHAL KUMAR ROY,Independent,613,7,620,0.28
44,Gazole,8,NIKHIL CHANDRA RAIBIR,Independent,2333,18,2351,1.06
44,Gazole,9,RINKU GHOSH,Independent,1384,9,1393,0.63
44,Gazole,10,NOTA,None of the Above,1950,31,1981,0.89
45,Chanchal,1,DEBA PRASAD ROY,Indian National Congress,15203,448,15651,7.03
45,Chanchal,2,SUMAN KANJILAL,Bharatiya Janata Party,105517,1816,107333,48.19
45,Chanchal,3,SOURAV CHAKRABORTY (GHUTIS),All India Trinamool Congress,90183,1143,91326,41
45,Chanchal,4,PIJUSH KANTI SARMA,SOCIALIST UNITY CENTRE OF INDIA (COMMUNIST),1090,21,1111,0.5
45,Chanchal,5,ABINASH DAS,Independent,267,3,270,0.12
45,Chanchal,6,ASHIM ROY,Independent,677,19,696,0.31
45,Chanchal,7,KUSHAL KUMAR ROY,Independent,613,7,620,0.28
45,Chanchal,8,NIKHIL CHANDRA RAIBIR,Independent,2333,18,2351,1.06
45,Chanchal,9,RINKU GHOSH,Independent,1384,9,1393,0.63
45,Chanchal,10,NOTA,None of the Above,1950,31,1981,0.89
46,Harischandrapur,1,DEBA PRASAD ROY,Indian National Congress,15203,448,15651,7.03
46,Harischandrapur,2,SUMAN KANJILAL,Bharatiya Janata Party,105517,1816,107333,48.19
46,Harischandrapur,3,SOURAV CHAKRABORTY (GHUTIS),All India Trinamool Congress,90183,1143,91326,41
46,Harischandrapur,4,PIJUSH KANTI SARMA,SOCIALIST UNITY CENTRE OF INDIA (COMMUNIST),1090,21,1111,0.5
46,Harischandrapur,5,ABINASH DAS,Independent,267,3,270,0.12
46,Harischandrapur,6,ASHIM ROY,Independent,677,19,696,0.31
46,Harischandrapur,7,KUSHAL KUMAR ROY,Independent,613,7,620,0.28
46,Harischandrapur,8,NIKHIL CHANDRA RAIBIR,Independent,2333,18,2351,1.06
46,Harischandrapur,9,RINKU GHOSH,Independent,1384,9,1393,0.63
46,Harischandrapur,10,NOTA,None of the Above,1950,31,1981,0.89
47,Malatipur,1,DEBA PRASAD ROY,Indian National Congress,15203,448,15651,7.03
47,Malatipur,2,SUMAN KANJILAL,Bharatiya Janata Party,105517,1816,107333,48.19
47,Malatipur,3,SOURAV CHAKRABORTY (GHUTIS),All India Trinamool Congress,90183,1143,91326,41
47,Malatipur,4,PIJUSH KANTI SARMA,SOCIALIST UNITY CENTRE OF INDIA (COMMUNIST),1090,21,1111,0.5
47,Malatipur,5,ABINASH DAS,Independent,267,3,270,0.12
47,Malatipur,6,ASHIM ROY,Independent,677,19,696,0.31
47,Malatipur,7,KUSHAL KUMAR ROY,Independent,613,7,620,0.28
47,Malatipur,8,NIKHIL CHANDRA RAIBIR,Independent,2333,18,2351,1.06
47,Malatipur,9,RINKU GHOSH,Independent,1384,9,1393,0.63
47,Malatipur,10,NOTA,None of the Above,1950,31,1981,0.89
48,Ratua,1,DEBA PRASAD ROY,Indian National Congress,15203,448,15651,7.03
48,Ratua,2,SUMAN KANJILAL,Bharatiya Janata Party,105517,1816,107333,48.19
48,Ratua,3,SOURAV CHAKRABORTY (GHUTIS),All India Trinamool Congress,90183,1143,91326,41
48,Ratua,4,PIJUSH KANTI SARMA,SOCIALIST UNITY CENTRE OF INDIA (COMMUNIST),1090,21,1111,0.5
48,Ratua,5,ABINASH DAS,Independent,267,3,270,0.12
48,Ratua,6,ASHIM ROY,Independent,677,19,696,0.31
48,Ratua,7,KUSHAL KUMAR ROY,Independent,613,7,620,0.28
48,Ratua,8,NIKHIL CHANDRA RAIBIR,Independent,2333,18,2351,1.06
48,Ratua,9,RINKU GHOSH,Independent,1384,9,1393,0.63
48,Ratua,10,NOTA,None of the Above,1950,31,1981,0.89
49,Manikchak,1,DEBA PRASAD ROY,Indian National Congress,15203,448,15651,7.03
49,Manikchak,2,SUMAN KANJILAL,Bharatiya Janata Party,105517,1816,107333,48.19
49,Manikchak,3,SOURAV CHAKRABORTY (GHUTIS),All India Trinamool Congress,90183,1143,91326,41
49,Manikchak,4,PIJUSH KANTI SARMA,SOCIALIST UNITY CENTRE OF INDIA (COMMUNIST),1090,21,1111,0.5
49,Manikchak,5,ABINASH DAS,Independent,267,3,270,0.12
49,Manikchak,6,ASHIM ROY,Independent,677,19,696,0.31
49,Manikchak,7,KUSHAL KUMAR ROY,Independent,613,7,620,0.28
49,Manikchak,8,NIKHIL CHANDRA RAIBIR,Independent,2333,18,2351,1.06
49,Manikchak,9,RINKU GHOSH,Independent,1384,9,1393,0.63
49,Manikchak,10,NOTA,None of the Above,1950,31,1981,0.89
50,Maldaha,1,DEBA PRASAD ROY,Indian National Congress,15203,448,15651,7.03
50,Maldaha,2,SUMAN KANJILAL,Bharatiya Janata Party,105517,1816,107333,48.19
50,Maldaha,3,SOURAV CHAKRABORTY (GHUTIS),All India Trinamool Congress,90183,1143,91326,41
50,Maldaha,4,PIJUSH KANTI SARMA,SOCIALIST UNITY CENTRE OF INDIA (COMMUNIST),1090,21,1111,0.5
50,Maldaha,5,ABINASH DAS,Independent,267,3,270,0.12
50,Maldaha,6,ASHIM ROY,Independent,677,19,696,0.31
50,Maldaha,7,KUSHAL KUMAR ROY,Independent,613,7,620,0.28
50,Maldaha,8,NIKHIL CHANDRA RAIBIR,Independent,2333,18,2351,1.06
50,Maldaha,9,RINKU GHOSH,Independent,1384,9,1393,0.63
50,Maldaha,10,NOTA,None of the Above,1950,31,1981,0.89
51,Englishbazar,1,DEBA PRASAD ROY,Indian National Congress,15203,448,15651,7.03
51,Englishbazar,2,SUMAN KANJILAL,Bharatiya Janata Party,105517,1816,107333,48.19
51,Englishbazar,3,SOURAV CHAKRABORTY (GHUTIS),All India Trinamool Congress,90183,1143,91326,41
51,Englishbazar,4,PIJUSH KANTI SARMA,SOCIALIST UNITY CENTRE OF INDIA (COMMUNIST),1090,21,1111,0.5
51,Englishbazar,5,ABINASH DAS,Independent,267,3,270,0.12
51,Englishbazar,6,ASHIM ROY,Independent,677,19,696,0.31
51,Englishbazar,7,KUSHAL KUMAR ROY,Independent,613,7,620,0.28
51,Englishbazar,8,NIKHIL CHANDRA RAIBIR,Independent,2333,18,2351,1.06
51,Englishbazar,9,RINKU GHOSH,Independent,1384,9,1393,0.63
51,Englishbazar,10,NOTA,None of the Above,1950,31,1981,0.89
52,Mothabari,1,DEBA PRASAD ROY,Indian National Congress,15203,448,15651,7.03
52,Mothabari,2,SUMAN KANJILAL,Bharatiya Janata Party,105517,1816,107333,48.19
52,Mothabari,3,SOURAV CHAKRABORTY (GHUTIS),All India Trinamool Congress,90183,1143,91326,41
52,Mothabari,4,PIJUSH KANTI SARMA,SOCIALIST UNITY CENTRE OF INDIA (COMMUNIST),1090,21,1111,0.5
52,Mothabari,5,ABINASH DAS,Independent,267,3,270,0.12
52,Mothabari,6,ASHIM ROY,Independent,677,19,696,0.31
52,Mothabari,7,KUSHAL KUMAR ROY,Independent,613,7,620,0.28
52,Mothabari,8,NIKHIL CHANDRA RAIBIR,Independent,2333,18,2351,1.06
52,Mothabari,9,RINKU GHOSH,Independent,1384,9,1393,0.63
52,Mothabari,10,NOTA,None of the Above,1950,31,1981,0.89
53,Sujapur,1,DEBA PRASAD ROY,Indian National Congress,15203,448,15651,7.03
53,Sujapur,2,SUMAN KANJILAL,Bharatiya Janata Party,105517,1816,107333,48.19
53,Sujapur,3,SOURAV CHAKRABORTY (GHUTIS),All India Trinamool Congress,90183,1143,91326,41
53,Sujapur,4,PIJUSH KANTI SARMA,SOCIALIST UNITY CENTRE OF INDIA (COMMUNIST),1090,21,1111,0.5
53,Sujapur,5,ABINASH DAS,Independent,267,3,270,0.12
53,Sujapur,6,ASHIM ROY,Independent,677,19,696,0.31
53,Sujapur,7,KUSHAL KUMAR ROY,Independent,613,7,620,0.28
53,Sujapur,8,NIKHIL CHANDRA RAIBIR,Independent,2333,18,2351,1.06
53,Sujapur,9,RINKU GHOSH,Independent,1384,9,1393,0.63
53,Sujapur,10,NOTA,None of the Above,1950,31,1981,0.89
54,Baisnabnagar,1,DEBA PRASAD ROY,Indian National Congress,15203,448,15651,7.03
54,Baisnabnagar,2,SUMAN KANJILAL,Bharatiya Janata Party,105517,1816,107333,48.19
54,Baisnabnagar,3,SOURAV CHAKRABORTY (GHUTIS),All India Trinamool Congress,90183,1143,91326,41
54,Baisnabnagar,4,PIJUSH KANTI SARMA,SOCIALIST UNITY CENTRE OF INDIA (COMMUNIST),1090,21,1111,0.5
54,Baisnabnagar,5,ABINASH DAS,Independent,267,3,270,0.12
54,Baisnabnagar,6,ASHIM ROY,Independent,677,19,696,0.31
54,Baisnabnagar,7,KUSHAL KUMAR ROY,Independent,613,7,620,0.28
54,Baisnabnagar,8,NIKHIL CHANDRA RAIBIR,Independent,2333,18,2351,1.06
54,Baisnabnagar,9,RINKU GHOSH,Independent,1384,9,1393,0.63
54,Baisnabnagar,10,NOTA,None of the Above,1950,31,1981,0.89
55,Farakka,1,DEBA PRASAD ROY,Indian National Congress,15203,448,15651,7.03
55,Farakka,2,SUMAN KANJILAL,Bharatiya Janata Party,105517,1816,107333,48.19
55,Farakka,3,SOURAV CHAKRABORTY (GHUTIS),All India Trinamool Congress,90183,1143,91326,41
55,Farakka,4,PIJUSH KANTI SARMA,SOCIALIST UNITY CENTRE OF INDIA (COMMUNIST),1090,21,1111,0.5
55,Farakka,5,ABINASH DAS,Independent,267,3,270,0.12
55,Farakka,6,ASHIM ROY,Independent,677,19,696,0.31
55,Farakka,7,KUSHAL KUMAR ROY,Independent,613,7,620,0.28
55,Farakka,8,NIKHIL CHANDRA RAIBIR,Independent,2333,18,2351,1.06
55,Farakka,9,RINKU GHOSH,Independent,1384,9,1393,0.63
55,Farakka,10,NOTA,None of the Above,1950,31,1981,0.89
57,Suti,1,DEBA PRASAD ROY,Indian National Congress,15203,448,15651,7.03
57,Suti,2,SUMAN KANJILAL,Bharatiya Janata Party,105517,1816,107333,48.19
57,Suti,3,SOURAV CHAKRABORTY (GHUTIS),All India Trinamool Congress,90183,1143,91326,41
57,Suti,4,PIJUSH KANTI SARMA,SOCIALIST UNITY CENTRE OF INDIA (COMMUNIST),1090,21,1111,0.5
57,Suti,5,ABINASH DAS,Independent,267,3,270,0.12
57,Suti,6,ASHIM ROY,Independent,677,19,696,0.31
57,Suti,7,KUSHAL KUMAR ROY,Independent,613,7,620,0.28
57,Suti,8,NIKHIL CHANDRA RAIBIR,Independent,2333,18,2351,1.06
57,Suti,9,RINKU GHOSH,Independent,1384,9,1393,0.63
57,Suti,10,NOTA,None of the Above,1950,31,1981,0.89
59,RaghunathGanj,1,DEBA PRASAD ROY,Indian National Congress,15203,448,15651,7.03
59,RaghunathGanj,2,SUMAN KANJILAL,Bharatiya Janata Party,105517,1816,107333,48.19
59,RaghunathGanj,3,SOURAV CHAKRABORTY (GHUTIS),All India Trinamool Congress,90183,1143,91326,41
59,RaghunathGanj,4,PIJUSH KANTI SARMA,SOCIALIST UNITY CENTRE OF INDIA (COMMUNIST),1090,21,1111,0.5
59,RaghunathGanj,5,ABINASH DAS,Independent,267,3,270,0.12
59,RaghunathGanj,6,ASHIM ROY,Independent,677,19,696,0.31
59,RaghunathGanj,7,KUSHAL KUMAR ROY,Independent,613,7,620,0.28
59,RaghunathGanj,8,NIKHIL CHANDRA RAIBIR,Independent,2333,18,2351,1.06
59,RaghunathGanj,9,RINKU GHOSH,Independent,1384,9,1393,0.63
59,RaghunathGanj,10,NOTA,None of the Above,1950,31,1981,0.89
60,Sagardighi,1,DEBA PRASAD ROY,Indian National Congress,15203,448,15651,7.03
60,Sagardighi,2,SUMAN KANJILAL,Bharatiya Janata Party,105517,1816,107333,48.19
60,Sagardighi,3,SOURAV CHAKRABORTY (GHUTIS),All India Trinamool Congress,90183,1143,91326,41
60,Sagardighi,4,PIJUSH KANTI SARMA,SOCIALIST UNITY CENTRE OF INDIA (COMMUNIST),1090,21,1111,0.5
60,Sagardighi,5,ABINASH DAS,Independent,267,3,270,0.12
60,Sagardighi,6,ASHIM ROY,Independent,677,19,696,0.31
60,Sagardighi,7,KUSHAL KUMAR ROY,Independent,613,7,620,0.28
60,Sagardighi,8,NIKHIL CHANDRA RAIBIR,Independent,2333,18,2351,1.06
60,Sagardighi,9,RINKU GHOSH,Independent,1384,9,1393,0.63
60,Sagardighi,10,NOTA,None of the Above,1950,31,1981,0.89
61,Lalgola,1,DEBA PRASAD ROY,Indian National Congress,15203,448,15651,7.03
61,Lalgola,2,SUMAN KANJILAL,Bharatiya Janata Party,105517,1816,107333,48.19
61,Lalgola,3,SOURAV CHAKRABORTY (GHUTIS),All India Trinamool Congress,90183,1143,91326,41
61,Lalgola,4,PIJUSH KANTI SARMA,SOCIALIST UNITY CENTRE OF INDIA (COMMUNIST),1090,21,1111,0.5
61,Lalgola,5,ABINASH DAS,Independent,267,3,270,0.12
61,Lalgola,6,ASHIM ROY,Independent,677,19,696,0.31
61,Lalgola,7,KUSHAL KUMAR ROY,Independent,613,7,620,0.28
61,Lalgola,8,NIKHIL CHANDRA RAIBIR,Independent,2333,18,2351,1.06
61,Lalgola,9,RINKU GHOSH,Independent,1384,9,1393,0.63
61,Lalgola,10,NOTA,None of the Above,1950,31,1981,0.89
62,Bhagabangola,1,DEBA PRASAD ROY,Indian National Congress,15203,448,15651,7.03
62,Bhagabangola,2,SUMAN KANJILAL,Bharatiya Janata Party,105517,1816,107333,48.19
62,Bhagabangola,3,SOURAV CHAKRABORTY (GHUTIS),All India Trinamool Congress,90183,1143,91326,41
62,Bhagabangola,4,PIJUSH KANTI SARMA,SOCIALIST UNITY CENTRE OF INDIA (COMMUNIST),1090,21,1111,0.5
62,Bhagabangola,5,ABINASH DAS,Independent,267,3,270,0.12
62,Bhagabangola,6,ASHIM ROY,Independent,677,19,696,0.31
62,Bhagabangola,7,KUSHAL KUMAR ROY,Independent,613,7,620,0.28
62,Bhagabangola,8,NIKHIL CHANDRA RAIBIR,Independent,2333,18,2351,1.06
62,Bhagabangola,9,RINKU GHOSH,Independent,1384,9,1393,0.63
62,Bhagabangola,10,NOTA,None of the Above,1950,31,1981,0.89
63,Raninagar,1,DEBA PRASAD ROY,Indian National Congress,15203,448,15651,7.03
63,Raninagar,2,SUMAN KANJILAL,Bharatiya Janata Party,105517,1816,107333,48.19
63,Raninagar,3,SOURAV CHAKRABORTY (GHUTIS),All India Trinamool Congress,90183,1143,91326,41
63,Raninagar,4,PIJUSH KANTI SARMA,SOCIALIST UNITY CENTRE OF INDIA (COMMUNIST),1090,21,1111,0.5
63,Raninagar,5,ABINASH DAS,Independent,267,3,270,0.12
63,Raninagar,6,ASHIM ROY,Independent,677,19,696,0.31
63,Raninagar,7,KUSHAL KUMAR ROY,Independent,613,7,620,0.28
63,Raninagar,8,NIKHIL CHANDRA RAIBIR,Independent,2333,18,2351,1.06
63,Raninagar,9,RINKU GHOSH,Independent,1384,9,1393,0.63
63,Raninagar,10,NOTA,None of the Above,1950,31,1981,0.89
64,Murshidabad,1,DEBA PRASAD ROY,Indian National Congress,15203,448,15651,7.03
64,Murshidabad,2,SUMAN KANJILAL,Bharatiya Janata Party,105517,1816,107333,48.19
64,Murshidabad,3,SOURAV CHAKRABORTY (GHUTIS),All India Trinamool Congress,90183,1143,91326,41
64,Murshidabad,4,PIJUSH KANTI SARMA,SOCIALIST UNITY CENTRE OF INDIA (COMMUNIST),1090,21,1111,0.5
64,Murshidabad,5,ABINASH DAS,Independent,267,3,270,0.12
64,Murshidabad,6,ASHIM ROY,Independent,677,19,696,0.31
64,Murshidabad,7,KUSHAL KUMAR ROY,Independent,613,7,620,0.28
64,Murshidabad,8,NIKHIL CHANDRA RAIBIR,Independent,2333,18,2351,1.06
64,Murshidabad,9,RINKU GHOSH,Independent,1384,9,1393,0.63
64,Murshidabad,10,NOTA,None of the Above,1950,31,1981,0.89
65,Nabagram,1,DEBA PRASAD ROY,Indian National Congress,15203,448,15651,7.03
65,Nabagram,2,SUMAN KANJILAL,Bharatiya Janata Party,105517,1816,107333,48.19
65,Nabagram,3,SOURAV CHAKRABORTY (GHUTIS),All India Trinamool Congress,90183,1143,91326,41
65,Nabagram,4,PIJUSH KANTI SARMA,SOCIALIST UNITY CENTRE OF INDIA (COMMUNIST),1090,21,1111,0.5
65,Nabagram,5,ABINASH DAS,Independent,267,3,270,0.12
65,Nabagram,6,ASHIM ROY,Independent,677,19,696,0.31
65,Nabagram,7,KUSHAL KUMAR ROY,Independent,613,7,620,0.28
65,Nabagram,8,NIKHIL CHANDRA RAIBIR,Independent,2333,18,2351,1.06
65,Nabagram,9,RINKU GHOSH,Independent,1384,9,1393,0.63
65,Nabagram,10,NOTA,None of the Above,1950,31,1981,0.89
66,Khargram,1,DEBA PRASAD ROY,Indian National Congress,15203,448,15651,7.03
66,Khargram,2,SUMAN KANJILAL,Bharatiya Janata Party,105517,1816,107333,48.19
66,Khargram,3,SOURAV CHAKRABORTY (GHUTIS),All India Trinamool Congress,90183,1143,91326,41
66,Khargram,4,PIJUSH KANTI SARMA,SOCIALIST UNITY CENTRE OF INDIA (COMMUNIST),1090,21,1111,0.5
66,Khargram,5,ABINASH DAS,Independent,267,3,270,0.12
66,Khargram,6,ASHIM ROY,Independent,677,19,696,0.31
66,Khargram,7,KUSHAL KUMAR ROY,Independent,613,7,620,0.28
66,Khargram,8,NIKHIL CHANDRA RAIBIR,Independent,2333,18,2351,1.06
66,Khargram,9,RINKU GHOSH,Independent,1384,9,1393,0.63
66,Khargram,10,NOTA,None of the Above,1950,31,1981,0.89
67,Burwan,1,DEBA PRASAD ROY,Indian National Congress,15203,448,15651,7.03
67,Burwan,2,SUMAN KANJILAL,Bharatiya Janata Party,105517,1816,107333,48.19
67,Burwan,3,SOURAV CHAKRABORTY (GHUTIS),All India Trinamool Congress,90183,1143,91326,41
67,Burwan,4,PIJUSH KANTI SARMA,SOCIALIST UNITY CENTRE OF INDIA (COMMUNIST),1090,21,1111,0.5
67,Burwan,5,ABINASH DAS,Independent,267,3,270,0.12
67,Burwan,6,ASHIM ROY,Independent,677,19,696,0.31
67,Burwan,7,KUSHAL KUMAR ROY,Independent,613,7,620,0.28
67,Burwan,8,NIKHIL CHANDRA RAIBIR,Independent,2333,18,2351,1.06
67,Burwan,9,RINKU GHOSH,Independent,1384,9,1393,0.63
67,Burwan,10,NOTA,None of the Above,1950,31,1981,0.89
68,Kandi,1,DEBA PRASAD ROY,Indian National Congress,15203,448,15651,7.03
68,Kandi,2,SUMAN KANJILAL,Bharatiya Janata Party,105517,1816,107333,48.19
68,Kandi,3,SOURAV CHAKRABORTY (GHUTIS),All India Trinamool Congress,90183,1143,91326,41
68,Kandi,4,PIJUSH KANTI SARMA,SOCIALIST UNITY CENTRE OF INDIA (COMMUNIST),1090,21,1111,0.5
68,Kandi,5,ABINASH DAS,Independent,267,3,270,0.12
68,Kandi,6,ASHIM ROY,Independent,677,19,696,0.31
68,Kandi,7,KUSHAL KUMAR ROY,Independent,613,7,620,0.28
68,Kandi,8,NIKHIL CHANDRA RAIBIR,Independent,2333,18,2351,1.06
68,Kandi,9,RINKU GHOSH,Independent,1384,9,1393,0.63
68,Kandi,10,NOTA,None of the Above,1950,31,1981,0.89
69,Bharatpur,1,DEBA PRASAD ROY,Indian National Congress,15203,448,15651,7.03
69,Bharatpur,2,SUMAN KANJILAL,Bharatiya Janata Party,105517,1816,107333,48.19
69,Bharatpur,3,SOURAV CHAKRABORTY (GHUTIS),All India Trinamool Congress,90183,1143,91326,41
69,Bharatpur,4,PIJUSH KANTI SARMA,SOCIALIST UNITY CENTRE OF INDIA (COMMUNIST),1090,21,1111,0.5
69,Bharatpur,5,ABINASH DAS,Independent,267,3,270,0.12
69,Bharatpur,6,ASHIM ROY,Independent,677,19,696,0.31
69,Bharatpur,7,KUSHAL KUMAR ROY,Independent,613,7,620,0.28
69,Bharatpur,8,NIKHIL CHANDRA RAIBIR,Independent,2333,18,2351,1.06
69,Bharatpur,9,RINKU GHOSH,Independent,1384,9,1393,0.63
69,Bharatpur,10,NOTA,None of the Above,1950,31,1981,0.89
70,Rejinagar,1,DEBA PRASAD ROY,Indian National Congress,15203,448,15651,7.03
70,Rejinagar,2,SUMAN KANJILAL,Bharatiya Janata Party,105517,1816,107333,48.19
70,Rejinagar,3,SOURAV CHAKRABORTY (GHUTIS),All India Trinamool Congress,90183,1143,91326,41
70,Rejinagar,4,PIJUSH KANTI SARMA,SOCIALIST UNITY CENTRE OF INDIA (COMMUNIST),1090,21,1111,0.5
70,Rejinagar,5,ABINASH DAS,Independent,267,3,270,0.12
70,Rejinagar,6,ASHIM ROY,Independent,677,19,696,0.31
70,Rejinagar,7,KUSHAL KUMAR ROY,Independent,613,7,620,0.28
70,Rejinagar,8,NIKHIL CHANDRA RAIBIR,Independent,2333,18,2351,1.06
70,Rejinagar,9,RINKU GHOSH,Independent,1384,9,1393,0.63
70,Rejinagar,10,NOTA,None of the Above,1950,31,1981,0.89
71,Beldanga,1,DEBA PRASAD ROY,Indian National Congress,15203,448,15651,7.03
71,Beldanga,2,SUMAN KANJILAL,Bharatiya Janata Party,105517,1816,107333,48.19
71,Beldanga,3,SOURAV CHAKRABORTY (GHUTIS),All India Trinamool Congress,90183,1143,91326,41
71,Beldanga,4,PIJUSH KANTI SARMA,SOCIALIST UNITY CENTRE OF INDIA (COMMUNIST),1090,21,1111,0.5
71,Beldanga,5,ABINASH DAS,Independent,267,3,270,0.12
71,Beldanga,6,ASHIM ROY,Independent,677,19,696,0.31
71,Beldanga,7,KUSHAL KUMAR ROY,Independent,613,7,620,0.28
71,Beldanga,8,NIKHIL CHANDRA RAIBIR,Independent,2333,18,2351,1.06
71,Beldanga,9,RINKU GHOSH,Independent,1384,9,1393,0.63
71,Beldanga,10,NOTA,None of the Above,1950,31,1981,0.89
72,Baharampur,1,DEBA PRASAD ROY,Indian National Congress,15203,448,15651,7.03
72,Baharampur,2,SUMAN KANJILAL,Bharatiya Janata Party,105517,1816,107333,48.19
72,Baharampur,3,SOURAV CHAKRABORTY (GHUTIS),All India Trinamool Congress,90183,1143,91326,41
72,Baharampur,4,PIJUSH KANTI SARMA,SOCIALIST UNITY CENTRE OF INDIA (COMMUNIST),1090,21,1111,0.5
72,Baharampur,5,ABINASH DAS,Independent,267,3,270,0.12
72,Baharampur,6,ASHIM ROY,Independent,677,19,696,0.31
72,Baharampur,7,KUSHAL KUMAR ROY,Independent,613,7,620,0.28
72,Baharampur,8,NIKHIL CHANDRA RAIBIR,Independent,2333,18,2351,1.06
72,Baharampur,9,RINKU GHOSH,Independent,1384,9,1393,0.63
72,Baharampur,10,NOTA,None of the Above,1950,31,1981,0.89
73,Hariharpara,1,DEBA PRASAD ROY,Indian National Congress,15203,448,15651,7.03
73,Hariharpara,2,SUMAN KANJILAL,Bharatiya Janata Party,105517,1816,107333,48.19
73,Hariharpara,3,SOURAV CHAKRABORTY (GHUTIS),All India Trinamool Congress,90183,1143,91326,41
73,Hariharpara,4,PIJUSH KANTI SARMA,SOCIALIST UNITY CENTRE OF INDIA (COMMUNIST),1090,21,1111,0.5
73,Hariharpara,5,ABINASH DAS,Independent,267,3,270,0.12
73,Hariharpara,6,ASHIM ROY,Independent,677,19,696,0.31
73,Hariharpara,7,KUSHAL KUMAR ROY,Independent,613,7,620,0.28
73,Hariharpara,8,NIKHIL CHANDRA RAIBIR,Independent,2333,18,2351,1.06
73,Hariharpara,9,RINKU GHOSH,Independent,1384,9,1393,0.63
73,Hariharpara,10,NOTA,None of the Above,1950,31,1981,0.89
74,Naoda,1,DEBA PRASAD ROY,Indian National Congress,15203,448,15651,7.03
74,Naoda,2,SUMAN KANJILAL,Bharatiya Janata Party,105517,1816,107333,48.19
74,Naoda,3,SOURAV CHAKRABORTY (GHUTIS),All India Trinamool Congress,90183,1143,91326,41
74,Naoda,4,PIJUSH KANTI SARMA,SOCIALIST UNITY CENTRE OF INDIA (COMMUNIST),1090,21,1111,0.5
74,Naoda,5,ABINASH DAS,Independent,267,3,270,0.12
74,Naoda,6,ASHIM ROY,Independent,677,19,696,0.31
74,Naoda,7,KUSHAL KUMAR ROY,Independent,613,7,620,0.28
74,Naoda,8,NIKHIL CHANDRA RAIBIR,Independent,2333,18,2351,1.06
74,Naoda,9,RINKU GHOSH,Independent,1384,9,1393,0.63
74,Naoda,10,NOTA,None of the Above,1950,31,1981,0.89
75,Domkal,1,DEBA PRASAD ROY,Indian National Congress,15203,448,15651,7.03
75,Domkal,2,SUMAN KANJILAL,Bharatiya Janata Party,105517,1816,107333,48.19
75,Domkal,3,SOURAV CHAKRABORTY (GHUTIS),All India Trinamool Congress,90183,1143,91326,41
75,Domkal,4,PIJUSH KANTI SARMA,SOCIALIST UNITY CENTRE OF INDIA (COMMUNIST),1090,21,1111,0.5
75,Domkal,5,ABINASH DAS,Independent,267,3,270,0.12
75,Domkal,6,ASHIM ROY,Independent,677,19,696,0.31
75,Domkal,7,KUSHAL KUMAR ROY,Independent,613,7,620,0.28
75,Domkal,8,NIKHIL CHANDRA RAIBIR,Independent,2333,18,2351,1.06
75,Domkal,9,RINKU GHOSH,Independent,1384,9,1393,0.63
75,Domkal,10,NOTA,None of the Above,1950,31,1981,0.89
76,Jalangi,1,DEBA PRASAD ROY,Indian National Congress,15203,448,15651,7.03
76,Jalangi,2,SUMAN KANJILAL,Bharatiya Janata Party,105517,1816,107333,48.19
76,Jalangi,3,SOURAV CHAKRABORTY (GHUTIS),All India Trinamool Congress,90183,1143,91326,41
76,Jalangi,4,PIJUSH KANTI SARMA,SOCIALIST UNITY CENTRE OF INDIA (COMMUNIST),1090,21,1111,0.5
76,Jalangi,5,ABINASH DAS,Independent,267,3,270,0.12
76,Jalangi,6,ASHIM ROY,Independent,677,19,696,0.31
76,Jalangi,7,KUSHAL KUMAR ROY,Independent,613,7,620,0.28
76,Jalangi,8,NIKHIL CHANDRA RAIBIR,Independent,2333,18,2351,1.06
76,Jalangi,9,RINKU GHOSH,Independent,1384,9,1393,0.63
76,Jalangi,10,NOTA,None of the Above,1950,31,1981,0.89
77,Karimpur,1,DEBA PRASAD ROY,Indian National Congress,15203,448,15651,7.03
77,Karimpur,2,SUMAN KANJILAL,Bharatiya Janata Party,105517,1816,107333,48.19
77,Karimpur,3,SOURAV CHAKRABORTY (GHUTIS),All India Trinamool Congress,90183,1143,91326,41
77,Karimpur,4,PIJUSH KANTI SARMA,SOCIALIST UNITY CENTRE OF INDIA (COMMUNIST),1090,21,1111,0.5
77,Karimpur,5,ABINASH DAS,Independent,267,3,270,0.12
77,Karimpur,6,ASHIM ROY,Independent,677,19,696,0.31
77,Karimpur,7,KUSHAL KUMAR ROY,Independent,613,7,620,0.28
77,Karimpur,8,NIKHIL CHANDRA RAIBIR,Independent,2333,18,2351,1.06
77,Karimpur,9,RINKU GHOSH,Independent,1384,9,1393,0.63
77,Karimpur,10,NOTA,None of the Above,1950,31,1981,0.89
78,Tehatta,1,DEBA PRASAD ROY,Indian National Congress,15203,448,15651,7.03
78,Tehatta,2,SUMAN KANJILAL,Bharatiya Janata Party,105517,1816,107333,48.19
78,Tehatta,3,SOURAV CHAKRABORTY (GHUTIS),All India Trinamool Congress,90183,1143,91326,41
78,Tehatta,4,PIJUSH KANTI SARMA,SOCIALIST UNITY CENTRE OF INDIA (COMMUNIST),1090,21,1111,0.5
78,Tehatta,5,ABINASH DAS,Independent,267,3,270,0.12
78,Tehatta,6,ASHIM ROY,Independent,677,19,696,0.31
78,Tehatta,7,KUSHAL KUMAR ROY,Independent,613,7,620,0.28
78,Tehatta,8,NIKHIL CHANDRA RAIBIR,Independent,2333,18,2351,1.06
78,Tehatta,9,RINKU GHOSH,Independent,1384,9,1393,0.63
78,Tehatta,10,NOTA,None of the Above,1950,31,1981,0.89
79,Palashipara,1,DEBA PRASAD ROY,Indian National Congress,15203,448,15651,7.03
79,Palashipara,2,SUMAN KANJILAL,Bharatiya Janata Party,105517,1816,107333,48.19
79,Palashipara,3,SOURAV CHAKRABORTY (GHUTIS),All India Trinamool Congress,90183,1143,91326,41
79,Palashipara,4,PIJUSH KANTI SARMA,SOCIALIST UNITY CENTRE OF INDIA (COMMUNIST),1090,21,1111,0.5
79,Palashipara,5,ABINASH DAS,Independent,267,3,270,0.12
79,Palashipara,6,ASHIM ROY,Independent,677,19,696,0.31
79,Palashipara,7,KUSHAL KUMAR ROY,Independent,613,7,620,0.28
79,Palashipara,8,NIKHIL CHANDRA RAIBIR,Independent,2333,18,2351,1.06
79,Palashipara,9,RINKU GHOSH,Independent,1384,9,1393,0.63
79,Palashipara,10,NOTA,None of the Above,1950,31,1981,0.89
80,Kaliganj,1,DEBA PRASAD ROY,Indian National Congress,15203,448,15651,7.03
80,Kaliganj,2,SUMAN KANJILAL,Bharatiya Janata Party,105517,1816,107333,48.19
80,Kaliganj,3,SOURAV CHAKRABORTY (GHUTIS),All India Trinamool Congress,90183,1143,91326,41
80,Kaliganj,4,PIJUSH KANTI SARMA,SOCIALIST UNITY CENTRE OF INDIA (COMMUNIST),1090,21,1111,0.5
80,Kaliganj,5,ABINASH DAS,Independent,267,3,270,0.12
80,Kaliganj,6,ASHIM ROY,Independent,677,19,696,0.31
80,Kaliganj,7,KUSHAL KUMAR ROY,Independent,613,7,620,0.28
80,Kaliganj,8,NIKHIL CHANDRA RAIBIR,Independent,2333,18,2351,1.06
80,Kaliganj,9,RINKU GHOSH,Independent,1384,9,1393,0.63
80,Kaliganj,10,NOTA,None of the Above,1950,31,1981,0.89
81,Nakashipara,1,DEBA PRASAD ROY,Indian National Congress,15203,448,15651,7.03
81,Nakashipara,2,SUMAN KANJILAL,Bharatiya Janata Party,105517,1816,107333,48.19
81,Nakashipara,3,SOURAV CHAKRABORTY (GHUTIS),All India Trinamool Congress,90183,1143,91326,41
81,Nakashipara,4,PIJUSH KANTI SARMA,SOCIALIST UNITY CENTRE OF INDIA (COMMUNIST),1090,21,1111,0.5
81,Nakashipara,5,ABINASH DAS,Independent,267,3,270,0.12
81,Nakashipara,6,ASHIM ROY,Independent,677,19,696,0.31
81,Nakashipara,7,KUSHAL KUMAR ROY,Independent,613,7,620,0.28
81,Nakashipara,8,NIKHIL CHANDRA RAIBIR,Independent,2333,18,2351,1.06
81,Nakashipara,9,RINKU GHOSH,Independent,1384,9,1393,0.63
81,Nakashipara,10,NOTA,None of the Above,1950,31,1981,0.89
82,Chapra,1,DEBA PRASAD ROY,Indian National Congress,15203,448,15651,7.03
82,Chapra,2,SUMAN KANJILAL,Bharatiya Janata Party,105517,1816,107333,48.19
82,Chapra,3,SOURAV CHAKRABORTY (GHUTIS),All India Trinamool Congress,90183,1143,91326,41
82,Chapra,4,PIJUSH KANTI SARMA,SOCIALIST UNITY CENTRE OF INDIA (COMMUNIST),1090,21,1111,0.5
82,Chapra,5,ABINASH DAS,Independent,267,3,270,0.12
82,Chapra,6,ASHIM ROY,Independent,677,19,696,0.31
82,Chapra,7,KUSHAL KUMAR ROY,Independent,613,7,620,0.28
82,Chapra,8,NIKHIL CHANDRA RAIBIR,Independent,2333,18,2351,1.06
82,Chapra,9,RINKU GHOSH,Independent,1384,9,1393,0.63
82,Chapra,10,NOTA,None of the Above,1950,31,1981,0.89
83,Krishnanagar Uttar,1,DEBA PRASAD ROY,Indian National Congress,15203,448,15651,7.03
83,Krishnanagar Uttar,2,SUMAN KANJILAL,Bharatiya Janata Party,105517,1816,107333,48.19
83,Krishnanagar Uttar,3,SOURAV CHAKRABORTY (GHUTIS),All India Trinamool Congress,90183,1143,91326,41
83,Krishnanagar Uttar,4,PIJUSH KANTI SARMA,SOCIALIST UNITY CENTRE OF INDIA (COMMUNIST),1090,21,1111,0.5
83,Krishnanagar Uttar,5,ABINASH DAS,Independent,267,3,270,0.12
83,Krishnanagar Uttar,6,ASHIM ROY,Independent,677,19,696,0.31
83,Krishnanagar Uttar,7,KUSHAL KUMAR ROY,Independent,613,7,620,0.28
83,Krishnanagar Uttar,8,NIKHIL CHANDRA RAIBIR,Independent,2333,18,2351,1.06
83,Krishnanagar Uttar,9,RINKU GHOSH,Independent,1384,9,1393,0.63
83,Krishnanagar Uttar,10,NOTA,None of the Above,1950,31,1981,0.89
84,Nabadwip,1,DEBA PRASAD ROY,Indian National Congress,15203,448,15651,7.03
84,Nabadwip,2,SUMAN KANJILAL,Bharatiya Janata Party,105517,1816,107333,48.19
84,Nabadwip,3,SOURAV CHAKRABORTY (GHUTIS),All India Trinamool Congress,90183,1143,91326,41
84,Nabadwip,4,PIJUSH KANTI SARMA,SOCIALIST UNITY CENTRE OF INDIA (COMMUNIST),1090,21,1111,0.5
84,Nabadwip,5,ABINASH DAS,Independent,267,3,270,0.12
84,Nabadwip,6,ASHIM ROY,Independent,677,19,696,0.31
84,Nabadwip,7,KUSHAL KUMAR ROY,Independent,613,7,620,0.28
84,Nabadwip,8,NIKHIL CHANDRA RAIBIR,Independent,2333,18,2351,1.06
84,Nabadwip,9,RINKU GHOSH,Independent,1384,9,1393,0.63
84,Nabadwip,10,NOTA,None of the Above,1950,31,1981,0.89
85,Krishnanagar Dakshin,1,DEBA PRASAD ROY,Indian National Congress,15203,448,15651,7.03
85,Krishnanagar Dakshin,2,SUMAN KANJILAL,Bharatiya Janata Party,105517,1816,107333,48.19
85,Krishnanagar Dakshin,3,SOURAV CHAKRABORTY (GHUTIS),All India Trinamool Congress,90183,1143,91326,41
85,Krishnanagar Dakshin,4,PIJUSH KANTI SARMA,SOCIALIST UNITY CENTRE OF INDIA (COMMUNIST),1090,21,1111,0.5
85,Krishnanagar Dakshin,5,ABINASH DAS,Independent,267,3,270,0.12
85,Krishnanagar Dakshin,6,ASHIM ROY,Independent,677,19,696,0.31
85,Krishnanagar Dakshin,7,KUSHAL KUMAR ROY,Independent,613,7,620,0.28
85,Krishnanagar Dakshin,8,NIKHIL CHANDRA RAIBIR,Independent,2333,18,2351,1.06
85,Krishnanagar Dakshin,9,RINKU GHOSH,Independent,1384,9,1393,0.63
85,Krishnanagar Dakshin,10,NOTA,None of the Above,1950,31,1981,0.89
86,Santipur,1,DEBA PRASAD ROY,Indian National Congress,15203,448,15651,7.03
86,Santipur,2,SUMAN KANJILAL,Bharatiya Janata Party,105517,1816,107333,48.19
86,Santipur,3,SOURAV CHAKRABORTY (GHUTIS),All India Trinamool Congress,90183,1143,91326,41
86,Santipur,4,PIJUSH KANTI SARMA,SOCIALIST UNITY CENTRE OF INDIA (COMMUNIST),1090,21,1111,0.5
86,Santipur,5,ABINASH DAS,Independent,267,3,270,0.12
86,Santipur,6,ASHIM ROY,Independent,677,19,696,0.31
86,Santipur,7,KUSHAL KUMAR ROY,Independent,613,7,620,0.28
86,Santipur,8,NIKHIL CHANDRA RAIBIR,Independent,2333,18,2351,1.06
86,Santipur,9,RINKU GHOSH,Independent,1384,9,1393,0.63
86,Santipur,10,NOTA,None of the Above,1950,31,1981,0.89
87,Ranaghat Uttar Paschim,1,DEBA PRASAD ROY,Indian National Congress,15203,448,15651,7.03
87,Ranaghat Uttar Paschim,2,SUMAN KANJILAL,Bharatiya Janata Party,105517,1816,107333,48.19
87,Ranaghat Uttar Paschim,3,SOURAV CHAKRABORTY (GHUTIS),All India Trinamool Congress,90183,1143,91326,41
87,Ranaghat Uttar Paschim,4,PIJUSH KANTI SARMA,SOCIALIST UNITY CENTRE OF INDIA (COMMUNIST),1090,21,1111,0.5
87,Ranaghat Uttar Paschim,5,ABINASH DAS,Independent,267,3,270,0.12
87,Ranaghat Uttar Paschim,6,ASHIM ROY,Independent,677,19,696,0.31
87,Ranaghat Uttar Paschim,7,KUSHAL KUMAR ROY,Independent,613,7,620,0.28
87,Ranaghat Uttar Paschim,8,NIKHIL CHANDRA RAIBIR,Independent,2333,18,2351,1.06
87,Ranaghat Uttar Paschim,9,RINKU GHOSH,Independent,1384,9,1393,0.63
87,Ranaghat Uttar Paschim,10,NOTA,None of the Above,1950,31,1981,0.89
88,Krishnaganj,1,DEBA PRASAD ROY,Indian National Congress,15203,448,15651,7.03
88,Krishnaganj,2,SUMAN KANJILAL,Bharatiya Janata Party,105517,1816,107333,48.19
88,Krishnaganj,3,SOURAV CHAKRABORTY (GHUTIS),All India Trinamool Congress,90183,1143,91326,41
88,Krishnaganj,4,PIJUSH KANTI SARMA,SOCIALIST UNITY CENTRE OF INDIA (COMMUNIST),1090,21,1111,0.5
88,Krishnaganj,5,ABINASH DAS,Independent,267,3,270,0.12
88,Krishnaganj,6,ASHIM ROY,Independent,677,19,696,0.31
88,Krishnaganj,7,KUSHAL KUMAR ROY,Independent,613,7,620,0.28
88,Krishnaganj,8,NIKHIL CHANDRA RAIBIR,Independent,2333,18,2351,1.06
88,Krishnaganj,9,RINKU GHOSH,Independent,1384,9,1393,0.63
88,Krishnaganj,10,NOTA,None of the Above,1950,31,1981,0.89
89,Ranaghat Uttar Purba,1,DEBA PRASAD ROY,Indian National Congress,15203,448,15651,7.03
89,Ranaghat Uttar Purba,2,SUMAN KANJILAL,Bharatiya Janata Party,105517,1816,107333,48.19
89,Ranaghat Uttar Purba,3,SOURAV CHAKRABORTY (GHUTIS),All India Trinamool Congress,90183,1143,91326,41
89,Ranaghat Uttar Purba,4,PIJUSH KANTI SARMA,SOCIALIST UNITY CENTRE OF INDIA (COMMUNIST),1090,21,1111,0.5
89,Ranaghat Uttar Purba,5,ABINASH DAS,Independent,267,3,270,0.12
89,Ranaghat Uttar Purba,6,ASHIM ROY,Independent,677,19,696,0.31
89,Ranaghat Uttar Purba,7,KUSHAL KUMAR ROY,Independent,613,7,620,0.28
89,Ranaghat Uttar Purba,8,NIKHIL CHANDRA RAIBIR,Independent,2333,18,2351,1.06
89,Ranaghat Uttar Purba,9,RINKU GHOSH,Independent,1384,9,1393,0.63
89,Ranaghat Uttar Purba,10,NOTA,None of the Above,1950,31,1981,0.89
90,Ranaghat Dakshin,1,DEBA PRASAD ROY,Indian National Congress,15203,448,15651,7.03
90,Ranaghat Dakshin,2,SUMAN KANJILAL,Bharatiya Janata Party,105517,1816,107333,48.19
90,Ranaghat Dakshin,3,SOURAV CHAKRABORTY (GHUTIS),All India Trinamool Congress,90183,1143,91326,41
90,Ranaghat Dakshin,4,PIJUSH KANTI SARMA,SOCIALIST UNITY CENTRE OF INDIA (COMMUNIST),1090,21,1111,0.5
90,Ranaghat Dakshin,5,ABINASH DAS,Independent,267,3,270,0.12
90,Ranaghat Dakshin,6,ASHIM ROY,Independent,677,19,696,0.31
90,Ranaghat Dakshin,7,KUSHAL KUMAR ROY,Independent,613,7,620,0.28
90,Ranaghat Dakshin,8,NIKHIL CHANDRA RAIBIR,Independent,2333,18,2351,1.06
90,Ranaghat Dakshin,9,RINKU GHOSH,Independent,1384,9,1393,0.63
90,Ranaghat Dakshin,10,NOTA,None of the Above,1950,31,1981,0.89
91,Chakdaha,1,DEBA PRASAD ROY,Indian National Congress,15203,448,15651,7.03
91,Chakdaha,2,SUMAN KANJILAL,Bharatiya Janata Party,105517,1816,107333,48.19
91,Chakdaha,3,SOURAV CHAKRABORTY (GHUTIS),All India Trinamool Congress,90183,1143,91326,41
91,Chakdaha,4,PIJUSH KANTI SARMA,SOCIALIST UNITY CENTRE OF INDIA (COMMUNIST),1090,21,1111,0.5
91,Chakdaha,5,ABINASH DAS,Independent,267,3,270,0.12
91,Chakdaha,6,ASHIM ROY,Independent,677,19,696,0.31
91,Chakdaha,7,KUSHAL KUMAR ROY,Independent,613,7,620,0.28
91,Chakdaha,8,NIKHIL CHANDRA RAIBIR,Independent,2333,18,2351,1.06
91,Chakdaha,9,RINKU GHOSH,Independent,1384,9,1393,0.63
91,Chakdaha,10,NOTA,None of the Above,1950,31,1981,0.89
92,Kalyani,1,DEBA PRASAD ROY,Indian National Congress,15203,448,15651,7.03
92,Kalyani,2,SUMAN KANJILAL,Bharatiya Janata Party,105517,1816,107333,48.19
92,Kalyani,3,SOURAV CHAKRABORTY (GHUTIS),All India Trinamool Congress,90183,1143,91326,41
92,Kalyani,4,PIJUSH KANTI SARMA,SOCIALIST UNITY CENTRE OF INDIA (COMMUNIST),1090,21,1111,0.5
92,Kalyani,5,ABINASH DAS,Independent,267,3,270,0.12
92,Kalyani,6,ASHIM ROY,Independent,677,19,696,0.31
92,Kalyani,7,KUSHAL KUMAR ROY,Independent,613,7,620,0.28
92,Kalyani,8,NIKHIL CHANDRA RAIBIR,Independent,2333,18,2351,1.06
92,Kalyani,9,RINKU GHOSH,Independent,1384,9,1393,0.63
92,Kalyani,10,NOTA,None of the Above,1950,31,1981,0.89
93,Haringhata,1,DEBA PRASAD ROY,Indian National Congress,15203,448,15651,7.03
93,Haringhata,2,SUMAN KANJILAL,Bharatiya Janata Party,105517,1816,107333,48.19
93,Haringhata,3,SOURAV CHAKRABORTY (GHUTIS),All India Trinamool Congress,90183,1143,91326,41
93,Haringhata,4,PIJUSH KANTI SARMA,SOCIALIST UNITY CENTRE OF INDIA (COMMUNIST),1090,21,1111,0.5
93,Haringhata,5,ABINASH DAS,Independent,267,3,270,0.12
93,Haringhata,6,ASHIM ROY,Independent,677,19,696,0.31
93,Haringhata,7,KUSHAL KUMAR ROY,Independent,613,7,620,0.28
93,Haringhata,8,NIKHIL CHANDRA RAIBIR,Independent,2333,18,2351,1.06
93,Haringhata,9,RINKU GHOSH,Independent,1384,9,1393,0.63
93,Haringhata,10,NOTA,None of the Above,1950,31,1981,0.89
94,Bagda,1,DEBA PRASAD ROY,Indian National Congress,15203,448,15651,7.03
94,Bagda,2,SUMAN KANJILAL,Bharatiya Janata Party,105517,1816,107333,48.19
94,Bagda,3,SOURAV CHAKRABORTY (GHUTIS),All India Trinamool Congress,90183,1143,91326,41
94,Bagda,4,PIJUSH KANTI SARMA,SOCIALIST UNITY CENTRE OF INDIA (COMMUNIST),1090,21,1111,0.5
94,Bagda,5,ABINASH DAS,Independent,267,3,270,0.12
94,Bagda,6,ASHIM ROY,Independent,677,19,696,0.31
94,Bagda,7,KUSHAL KUMAR ROY,Independent,613,7,620,0.28
94,Bagda,8,NIKHIL CHANDRA RAIBIR,Independent,2333,18,2351,1.06
94,Bagda,9,RINKU GHOSH,Independent,1384,9,1393,0.63
94,Bagda,10,NOTA,None of the Above,1950,31,1981,0.89
95,Bangaon Uttar,1,DEBA PRASAD ROY,Indian National Congress,15203,448,15651,7.03
95,Bangaon Uttar,2,SUMAN KANJILAL,Bharatiya Janata Party,105517,1816,107333,48.19
95,Bangaon Uttar,3,SOURAV CHAKRABORTY (GHUTIS),All India Trinamool Congress,90183,1143,91326,41
95,Bangaon Uttar,4,PIJUSH KANTI SARMA,SOCIALIST UNITY CENTRE OF INDIA (COMMUNIST),1090,21,1111,0.5
95,Bangaon Uttar,5,ABINASH DAS,Independent,267,3,270,0.12
95,Bangaon Uttar,6,ASHIM ROY,Independent,677,19,696,0.31
95,Bangaon Uttar,7,KUSHAL KUMAR ROY,Independent,613,7,620,0.28
95,Bangaon Uttar,8,NIKHIL CHANDRA RAIBIR,Independent,2333,18,2351,1.06
95,Bangaon Uttar,9,RINKU GHOSH,Independent,1384,9,1393,0.63
95,Bangaon Uttar,10,NOTA,None of the Above,1950,31,1981,0.89
96,Bangaon Dakshin,1,DEBA PRASAD ROY,Indian National Congress,15203,448,15651,7.03
96,Bangaon Dakshin,2,SUMAN KANJILAL,Bharatiya Janata Party,105517,1816,107333,48.19
96,Bangaon Dakshin,3,SOURAV CHAKRABORTY (GHUTIS),All India Trinamool Congress,90183,1143,91326,41
96,Bangaon Dakshin,4,PIJUSH KANTI SARMA,SOCIALIST UNITY CENTRE OF INDIA (COMMUNIST),1090,21,1111,0.5
96,Bangaon Dakshin,5,ABINASH DAS,Independent,267,3,270,0.12
96,Bangaon Dakshin,6,ASHIM ROY,Independent,677,19,696,0.31
96,Bangaon Dakshin,7,KUSHAL KUMAR ROY,Independent,613,7,620,0.28
96,Bangaon Dakshin,8,NIKHIL CHANDRA RAIBIR,Independent,2333,18,2351,1.06
96,Bangaon Dakshin,9,RINKU GHOSH,Independent,1384,9,1393,0.63
96,Bangaon Dakshin,10,NOTA,None of the Above,1950,31,1981,0.89
97,Gaighata,1,DEBA PRASAD ROY,Indian National Congress,15203,448,15651,7.03
97,Gaighata,2,SUMAN KANJILAL,Bharatiya Janata Party,105517,1816,107333,48.19
97,Gaighata,3,SOURAV CHAKRABORTY (GHUTIS),All India Trinamool Congress,90183,1143,91326,41
97,Gaighata,4,PIJUSH KANTI SARMA,SOCIALIST UNITY CENTRE OF INDIA (COMMUNIST),1090,21,1111,0.5
97,Gaighata,5,ABINASH DAS,Independent,267,3,270,0.12
97,Gaighata,6,ASHIM ROY,Independent,677,19,696,0.31
97,Gaighata,7,KUSHAL KUMAR ROY,Independent,613,7,620,0.28
97,Gaighata,8,NIKHIL CHANDRA RAIBIR,Independent,2333,18,2351,1.06
97,Gaighata,9,RINKU GHOSH,Independent,1384,9,1393,0.63
97,Gaighata,10,NOTA,None of the Above,1950,31,1981,0.89
